	cluster
AAACAAGTATCTCCCA-1	Cortex_2
AAACAATCTACTAGCA-1	Cortex_5
AAACACCAATAACTGC-1	Thalamus_2
AAACAGAGCGACTCCT-1	Cortex_5
AAACCGGGTAGGTACC-1	Thalamus_2
AAACCGTTCGTCCAGG-1	Hypothalamus_2
AAACCTCATGAAGTTG-1	Thalamus_2
AAACGAAGAACATACC-1	Cortex_4
AAACGAGACGGTTGAT-1	Fiber_tract
AAACGGTTGCGAACTG-1	Lateral_ventricle
AAACTCGGTTCGCAAT-1	Cortex_5
AAACTGCTGGCTCCAA-1	Fiber_tract
AAACTTGCAAACGTAT-1	Thalamus_2
AAAGACCCAAGTCGCG-1	Cortex_1
AAAGGCCCTATAATAC-1	Hypothalamus_1
AAAGGCTACGGACCAT-1	Striatum
AAAGGCTCTCGCGCCG-1	Fiber_tract
AAAGGGATGTAGCAAG-1	Hippocampus
AAAGGGCAGCTTGAAT-1	Pyramidal_layer
AAAGTAGCATTGCTCA-1	Thalamus_1
AAAGTCACTGATGTAA-1	Cortex_1
AAAGTCGACCCTCAGT-1	Thalamus_2
AAAGTGTGATTTATCT-1	Cortex_3
AAAGTTGACTCCCGTA-1	Cortex_3
AAATAACCATACGGGA-1	Cortex_4
AAATACCTATAAGCAT-1	Lateral_ventricle
AAATAGCTTAGACTTT-1	Cortex_5
AAATAGGGTGCTATTG-1	Cortex_2
AAATCGTGTACCACAA-1	Hypothalamus_2
AAATGCTCGTTACGTT-1	Fiber_tract
AAATGGCATGTCTTGT-1	Cortex_1
AAATGGCCCGTGCCCT-1	Thalamus_2
AAATGGTCAATGTGCC-1	Thalamus_1
AAATTAACGGGTAGCT-1	Thalamus_1
AAATTACACGACTCTG-1	Cortex_4
AAATTACCTATCGATG-1	Cortex_1
AAATTGATAGTCCTTT-1	Hypothalamus_2
AAATTGCGGCGGTTCT-1	Cortex_1
AAATTTGCGGGTGTGG-1	Thalamus_1
AACAACTGGTAGTTGC-1	Hypothalamus_2
AACAATACATTGTCGA-1	Hypothalamus_1
AACAATTACTCTACGC-1	Lateral_ventricle
AACACACGCTCGCCGC-1	Cortex_2
AACACGACTGTACTGA-1	Cortex_1
AACACGAGACGCGGCC-1	Thalamus_2
AACACGCGGCCGCGAA-1	Cortex_1
AACAGCTGTGTGGCAA-1	Hypothalamus_1
AACAGGAAATCGAATA-1	Cortex_3
AACAGGATGGGCCGCG-1	Thalamus_2
AACATATCAACTGGTG-1	Cortex_4
AACATTGAAGTTGATC-1	Hypothalamus_1
AACATTGTGACTCGAG-1	Striatum
AACCAAGACTTCTCTG-1	Thalamus_2
AACCATGGGATCGCTA-1	Fiber_tract
AACCCAGAGACGGAGA-1	Hippocampus
AACCCTACTGTCAATA-1	Cortex_3
AACCCTGGTGGAACCA-1	Cortex_4
AACCGAGCTTGGTCAT-1	Hippocampus
AACCGCTAAGGGATGC-1	Cortex_3
AACCGTTGTGTTTGCT-1	Cortex_1
AACCTCGCTTTAGCCC-1	Cortex_2
AACCTTTAAATACGGT-1	Cortex_2
AACCTTTACGACGTCT-1	Cortex_4
AACGATAATGCCGTAG-1	Cortex_2
AACGATAGAAGGGCCG-1	Fiber_tract
AACGATATGTCAACTG-1	Fiber_tract
AACGCGAACGGCAACA-1	Cortex_1
AACGCGACCTTGGGCG-1	Lateral_ventricle
AACGCGGTCTCCAGCC-1	Pyramidal_layer
AACGCTGTTGCTGAAA-1	Cortex_2
AACGGACGTACGTATA-1	Cortex_3
AACGGCCATCTCCGGT-1	Thalamus_1
AACGTACTGTGGGTAC-1	Hypothalamus_2
AACGTCAGACTAGTGG-1	Pyramidal_layer_dentate_gyrus
AACGTGATGAAGGACA-1	Cortex_4
AACGTGCGAAAGTCTC-1	Lateral_ventricle
AACTAGCGTATCGCAC-1	Cortex_4
AACTAGGCTTGGGTGT-1	Striatum
AACTCAAGTTAATTGC-1	Thalamus_1
AACTCCAGAGCGTGTT-1	Cortex_2
AACTCCTAATCCCATG-1	Cortex_4
AACTCGATGGCGCAGT-1	Cortex_3
AACTCTCAATAGAGCG-1	Cortex_3
AACTCTCAGTGTGCTC-1	Hypothalamus_2
AACTGATATTAGGCCT-1	Cortex_3
AACTGGGTCCCGACGT-1	Hippocampus
AACTGGTGTGGGCCTT-1	Cortex_1
AACTTCTGCGTCTATC-1	Fiber_tract
AACTTGCCCGTATGCA-1	Thalamus_2
AACTTGCGTTCTCGCG-1	Hippocampus
AACTTTAGCTGCTGAG-1	Cortex_4
AAGAAGGATCAGTTAG-1	Cortex_3
AAGACCCAACTGAACA-1	Striatum
AAGACTAACCCGTTGT-1	Cortex_1
AAGACTGCAAGCTACT-1	Fiber_tract
AAGAGATGAATCGGTA-1	Lateral_ventricle
AAGAGCTCTTTATCGG-1	Lateral_ventricle
AAGAGGATGTACGCGA-1	Thalamus_2
AAGAGGCATGGATCGC-1	Striatum
AAGATGGCACCGGACC-1	Hypothalamus_1
AAGATTGGCGGAACGT-1	Cortex_1
AAGCACCCTGCGTATC-1	Cortex_2
AAGCATACTCTCCTGA-1	Cortex_2
AAGCCGCCGTGAAATC-1	Hypothalamus_1
AAGCGTCCCTCATCGA-1	Hypothalamus_1
AAGCTAGATCGAGTAA-1	Striatum
AAGCTCGTGCCAAGTC-1	Fiber_tract
AAGCTCTTTCATGGTG-1	Cortex_2
AAGGAGAACTTATAAG-1	Cortex_5
AAGGAGCGGTTGGTGC-1	Thalamus_1
AAGGATGAGGGACCTC-1	Cortex_1
AAGGCGCGTAAAGCTT-1	Pyramidal_layer_dentate_gyrus
AAGGCTGTGCTCATCG-1	Thalamus_1
AAGGGAACGACTGGCT-1	Hypothalamus_1
AAGGGACAGATTCTGT-1	Cortex_1
AAGGGACTATGCATTC-1	Hypothalamus_1
AAGGTATCCTAATATA-1	Cortex_3
AAGGTGATAAACCAGC-1	Cortex_3
AAGTAGAAGACCGGGT-1	Hippocampus
AAGTAGTGACGCGAGG-1	Thalamus_1
AAGTCAATTGTCGTCA-1	Cortex_2
AAGTGACGACCGAATT-1	Thalamus_2
AAGTGAGTCGGGTTTA-1	Lateral_ventricle
AAGTGCCTTGACTGTA-1	Cortex_2
AAGTGCGTTAGAATCT-1	Thalamus_1
AAGTGCTTCTCTATTG-1	Hypothalamus_1
AAGTGTTTGGAGACGG-1	Cortex_2
AAGTTCACTCCAAGCT-1	Cortex_5
AAGTTCGGCCAACAGG-1	Thalamus_1
AAGTTTACTAATGGCA-1	Cortex_4
AATAACAACGCTCGGC-1	Thalamus_2
AATAACACTAGAACAA-1	Hypothalamus_2
AATAAGTCCTCGAGAC-1	Cortex_5
AATACAATGTTTCAGG-1	Hippocampus
AATACCGGAGGGCTGT-1	Hypothalamus_1
AATAGAACAGAGTGGC-1	Hypothalamus_2
AATAGAATCTGTTTCA-1	Cortex_2
AATAGTCCGTCCCGAC-1	Striatum
AATATCAAGGTCGGAT-1	Cortex_1
AATATCGAGGGTTCTC-1	Cortex_4
AATATTGGAGTATTGA-1	Fiber_tract
AATCAGACTGCAGGAC-1	Cortex_1
AATCAGGTTTCATTTA-1	Hypothalamus_1
AATCATGTAAAGACTC-1	Cortex_2
AATCCAAGGGCCTGAG-1	Cortex_3
AATCCATGCAAGGGTG-1	Cortex_1
AATCGCCTCAGCGCCA-1	Striatum
AATCGGGACACTACGA-1	Cortex_1
AATCTAGGTTTACTTG-1	Thalamus_2
AATCTGCGTTGGGACG-1	Cortex_3
AATCTGGCTTTCTAGT-1	Thalamus_2
AATGACAGCAATGTCT-1	Thalamus_1
AATGACGTAGGATGTC-1	Striatum
AATGACTGTCAGCCGG-1	Hippocampus
AATGAGTTCGCATATG-1	Hippocampus
AATGATGATACGCTAT-1	Cortex_1
AATGATGCGACTCCTG-1	Cortex_5
AATGCAACCGGGTACC-1	Hippocampus
AATGCACCAAGCAATG-1	Cortex_5
AATGGTTCTCACAAGC-1	Hippocampus
AATGTGCCCGAGGTGT-1	Hypothalamus_2
AATGTGCTAATCTGAG-1	Hypothalamus_1
AATTAAAGGTCGGCGT-1	Thalamus_1
AATTAACGGATTTCCA-1	Cortex_2
AATTAGCGCTGCAGCG-1	Striatum
AATTCATAAGGGATCT-1	Cortex_1
AATTCCAAGCATGTAC-1	Lateral_ventricle
AATTCTAGAGTTAGGC-1	Fiber_tract
AATTGAACGCTCTGGT-1	Cortex_2
AATTTGGGACATAGTA-1	Cortex_4
AATTTGGTTCCAAAGA-1	Cortex_1
ACAAACCATGCGTCCT-1	Hypothalamus_1
ACAAATCGCACCGAAT-1	Cortex_2
ACAAATGGTAGTGTTT-1	Cortex_2
ACAACAGCATGAGCTA-1	Hippocampus
ACAACGGTCCCTGCGA-1	Pyramidal_layer
ACAAGCAGTGCCTAGC-1	Thalamus_2
ACAAGGAAATCCGCCC-1	Striatum
ACAAGGACAAGAGGTT-1	Thalamus_1
ACAAGGATGCTTTAGG-1	Cortex_2
ACAAGGGCAGGCTCTG-1	Striatum
ACAATAGTCGTACGTT-1	Thalamus_2
ACAATCCATTTAAACC-1	Thalamus_2
ACAATGAATACGGAGA-1	Hypothalamus_1
ACAATTGTGTCTCTTT-1	Cortex_2
ACAATTTGAGCAGTGG-1	Cortex_3
ACACAAAGACGGGTGG-1	Hippocampus
ACACACCAGGACCAGT-1	Cortex_3
ACACACTTTCTACACG-1	Cortex_3
ACACATGATCAAATCT-1	Thalamus_2
ACACCCAGCATGCAGC-1	Hippocampus
ACACCCGAGAAATCCG-1	Hippocampus
ACACCGGTCTGACCGC-1	Hypothalamus_1
ACACCTTAAGTAGGGC-1	Pyramidal_layer_dentate_gyrus
ACACGAGACTCCTTCT-1	Hippocampus
ACACGGCACTATGCAT-1	Cortex_4
ACACGGGAACTTAGGG-1	Hippocampus
ACACTCCAATGTCACT-1	Cortex_1
ACACTGATCAAGGTGT-1	Hypothalamus_2
ACAGAACTGAGAACAA-1	Thalamus_1
ACAGATTAGGTTAGTG-1	Cortex_4
ACAGCATAGAGCCAGT-1	Cortex_1
ACAGCGCACCCGCAGC-1	Cortex_4
ACAGGCTTGCCCGACT-1	Cortex_3
ACAGGTGGAGGTGAGG-1	Hypothalamus_2
ACATAATAAGGCGGTG-1	Pyramidal_layer
ACATCCCGGCCATACG-1	Striatum
ACATCCTGGTAACTGT-1	Cortex_4
ACATCGATCGTTTACC-1	Hypothalamus_2
ACATCGGTCAGCCGCG-1	Thalamus_1
ACATCGTATGCAATGG-1	Cortex_2
ACATCGTTAACCTAGT-1	Cortex_4
ACATGGCGCCAAAGTA-1	Cortex_5
ACATTAGTTTATATCC-1	Fiber_tract
ACCAACGCTTATTTAT-1	Fiber_tract
ACCAAGAACGCGTGTC-1	Pyramidal_layer
ACCAATATGCAAGTTA-1	Cortex_2
ACCACAACTCAGAACA-1	Cortex_5
ACCACAAGTTTCTATC-1	Thalamus_1
ACCACGTGCAGCTATA-1	Cortex_2
ACCAGGAGTGTGATCT-1	Cortex_5
ACCAGTGCGGGAGACG-1	Cortex_2
ACCATATCCGCAATAA-1	Fiber_tract
ACCATCGTATATGGTA-1	Thalamus_1
ACCCAACGCCCGTGGC-1	Cortex_3
ACCCACCTACATGCTC-1	Hippocampus
ACCCATCTTGAGGGTA-1	Thalamus_1
ACCCGAGCGAAATTAC-1	Hypothalamus_1
ACCCGATTGGTTCCGA-1	Hypothalamus_1
ACCCGGAAACTCCCAG-1	Cortex_2
ACCCGGATGACGCATC-1	Cortex_1
ACCCGGTTACACTTCC-1	Thalamus_1
ACCCGTGTCATCAGTA-1	Striatum
ACCCTATAGGACTGAG-1	Hippocampus
ACCCTATGCCATATCG-1	Hypothalamus_1
ACCCTCCCTTGCTATT-1	Cortex_2
ACCCTTCATCTGCGAA-1	Cortex_1
ACCGAAAGGGCCCTGC-1	Cortex_1
ACCGACACATCTCCCA-1	Cortex_2
ACCGACTGAGTCCCAC-1	Hippocampus
ACCGATGGTAGCATCG-1	Cortex_3
ACCGCAATAACTGCCT-1	Cortex_2
ACCGCGGTGGAAGTCG-1	Cortex_5
ACCGGGCCTTTGTTGA-1	Cortex_3
ACCGGTCAGGTACACC-1	Thalamus_2
ACCGTGACCACGTGGG-1	Hypothalamus_1
ACCGTTCCCGCTCTGA-1	Cortex_5
ACCTAAGTACCTTTCA-1	Thalamus_2
ACCTAATCGACTTCCT-1	Thalamus_1
ACCTCGAACTTATGCT-1	Hypothalamus_1
ACCTGCGTGTCATGTT-1	Thalamus_2
ACGAAATGGGCGGCAC-1	Thalamus_2
ACGACTGGTCATACTC-1	Hypothalamus_1
ACGAGAACCCATCACG-1	Cortex_1
ACGAGATATTTGCTTA-1	Cortex_4
ACGAGGATACCACTCT-1	Thalamus_2
ACGATACATAGAACTA-1	Cortex_3
ACGATCATACATAGAG-1	Hippocampus
ACGATCATCTTGTAAA-1	Cortex_4
ACGATGCATATGTTAT-1	Thalamus_1
ACGATGGATCCGATGC-1	Cortex_1
ACGCAAACTAATAGAT-1	Lateral_ventricle
ACGCATTCGTGAGTAC-1	Hypothalamus_2
ACGCCAGATGATTTCT-1	Cortex_3
ACGCCGCTAGACGACC-1	Lateral_ventricle
ACGCGAAGTCAGACGA-1	Fiber_tract
ACGCGCTACACAGGGT-1	Thalamus_2
ACGCGGGCCAAGGACA-1	Lateral_ventricle
ACGCTAGTGATACACT-1	Cortex_4
ACGGAATTTAGCAAAT-1	Fiber_tract
ACGGACTCTCAAAGCG-1	Cortex_2
ACGGATGGTGCGGATA-1	Cortex_2
ACGGCACTTGCTTGGG-1	Lateral_ventricle
ACGGCCAACATGGACT-1	Fiber_tract
ACGGCGACGATGGGAA-1	Cortex_2
ACGGCGGGTTGCCCTG-1	Cortex_4
ACGGGAGTGTCGGCCC-1	Thalamus_1
ACGGTCACCGAGAACA-1	Hypothalamus_1
ACGTACAGATTTCTCT-1	Cortex_1
ACGTACTTTGGCACGG-1	Hypothalamus_1
ACGTAGATTGCTGATG-1	Hippocampus
ACGTATTACTCCGATC-1	Cortex_3
ACGTGCGCCTCGTGCA-1	Cortex_3
ACGTTAATGTCGAAGA-1	Lateral_ventricle
ACGTTAGATTTGCCCG-1	Thalamus_1
ACGTTCCGCGCTCCGT-1	Cortex_1
ACGTTCGTTCAGGAAA-1	Hypothalamus_1
ACGTTTAGTTGTGATC-1	Cortex_1
ACTACATCCCGACAAG-1	Hypothalamus_1
ACTACCAGCTCTCTGG-1	Pyramidal_layer_dentate_gyrus
ACTACGCGTTAGAATT-1	Striatum
ACTAGTTGCGATCGTC-1	Cortex_5
ACTATGTCCAGCTGCC-1	Hypothalamus_1
ACTATTCGTCCGTGGT-1	Cortex_1
ACTATTTCCGGGCCCA-1	Hypothalamus_1
ACTCAACGAATGTATT-1	Cortex_1
ACTCAAGTGCAAGGCT-1	Cortex_2
ACTCAATAAAGGCACG-1	Pyramidal_layer_dentate_gyrus
ACTCAGACCTGCTTCT-1	Cortex_1
ACTCATGGCAGCCTTC-1	Hypothalamus_1
ACTCCAATATCATCAT-1	Hypothalamus_1
ACTCCCATTCCTAAAG-1	Thalamus_2
ACTCCCGAATTCGTTT-1	Cortex_5
ACTCCCTAATGCTAAA-1	Cortex_2
ACTCCCTAGAATAGTA-1	Striatum
ACTCGTAACCCGTCCT-1	Thalamus_1
ACTCGTCAGTAATCCC-1	Fiber_tract
ACTCTCTGACTTAGGT-1	Striatum
ACTCTCTTATACACGA-1	Cortex_5
ACTCTTGTATAGTAAC-1	Fiber_tract
ACTGAAACGCCGTTAG-1	Cortex_2
ACTGAATGGCGAAAGT-1	Cortex_2
ACTGCCCGCCATTCTC-1	Hypothalamus_1
ACTGCCGTCGTAACTC-1	Cortex_3
ACTGTACGATACACAT-1	Fiber_tract
ACTGTAGCACTTTGGA-1	Hippocampus
ACTGTATACGCGAGCA-1	Cortex_1
ACTGTCCAGGATTATA-1	Thalamus_1
ACTGTCTTCTTTAGAA-1	Pyramidal_layer_dentate_gyrus
ACTGTGCTAGTAGATC-1	Cortex_3
ACTTACCGGGCGCGCA-1	Cortex_5
ACTTACGCATCCACGC-1	Cortex_2
ACTTAGTACGACAAGA-1	Fiber_tract
ACTTATACTTACCCGG-1	Cortex_3
ACTTATCTGATCTATA-1	Cortex_4
ACTTATTAGGATCGGT-1	Thalamus_1
ACTTATTTATGTGCCA-1	Cortex_3
ACTTCAGGCTGATCCC-1	Cortex_2
ACTTCCATGCGGGACA-1	Cortex_2
ACTTCGCCATACGCAC-1	Lateral_ventricle
ACTTGACTCCCTCTTT-1	Lateral_ventricle
ACTTGCCATATTGTAC-1	Cortex_5
ACTTGGGACCCGGTGG-1	Thalamus_1
ACTTTACCCTCATGAA-1	Cortex_5
ACTTTCCTATAGCTTC-1	Hippocampus
AGAACGTGGTACATTC-1	Hippocampus
AGAAGGTTGCCGAATT-1	Thalamus_1
AGAAGGTTGTAGGTCG-1	Cortex_2
AGAAGTGATTCGTGAT-1	Thalamus_1
AGAATTATGGATTCGA-1	Cortex_1
AGAATTGTTTGACATA-1	Fiber_tract
AGACATAGATCCTTCC-1	Cortex_5
AGACCATGGGATACAA-1	Pyramidal_layer
AGACCCACCGCTGATC-1	Fiber_tract
AGACCCGCCCTCCTCG-1	Hippocampus
AGACCGGGAAACCCTG-1	Thalamus_2
AGACGAAGTGCCGGTC-1	Cortex_3
AGACGACGATGCCGCT-1	Hypothalamus_2
AGACTAGCCTTCCAGA-1	Thalamus_1
AGACTGTTACCGGGTC-1	Lateral_ventricle
AGAGAAACACCAGAAA-1	Hypothalamus_1
AGAGAACCGTCTAGGA-1	Cortex_1
AGAGAAGGAGTACAAT-1	Hypothalamus_1
AGAGATCTCTAAAGCG-1	Thalamus_2
AGAGCAGTTATGAGAC-1	Thalamus_2
AGAGCGGGCTAATCAT-1	Cortex_3
AGAGCGTACAAGCTCG-1	Hippocampus
AGAGGCTTCGGAAACC-1	Cortex_2
AGAGGTATCTCGGTCC-1	Cortex_5
AGAGTAAACTTCACTA-1	Cortex_5
AGATAACTTCAGGGCC-1	Thalamus_1
AGATACCGGTGTTCAC-1	Thalamus_1
AGATACGACTTCATAT-1	Fiber_tract
AGATACTCAAGATCGA-1	Cortex_2
AGATATAATACGACTA-1	Cortex_2
AGATCGTGCATAAGAT-1	Cortex_4
AGATCTCAGGTGTGAT-1	Fiber_tract
AGATGACTCGCCCACG-1	Hippocampus
AGATGATGGAGTCTGG-1	Lateral_ventricle
AGATGCAAGACGTGCA-1	Thalamus_2
AGATTATAGGACGTTT-1	Thalamus_1
AGCAAAGGCCGCTAGT-1	Cortex_2
AGCAACATATCTTATT-1	Cortex_3
AGCAACCGAAAGTAAT-1	Thalamus_2
AGCACACGTTTAGACT-1	Hypothalamus_1
AGCACCAGTACTCACG-1	Hippocampus
AGCACTACCGGCCTGT-1	Thalamus_2
AGCACTACCTCACCAG-1	Cortex_2
AGCACTTAAGGACGCC-1	Thalamus_1
AGCAGAAGGAGAAAGA-1	Cortex_2
AGCAGCCAGATGAATA-1	Striatum
AGCATATCAATATGCT-1	Cortex_2
AGCATCATTTCGAAAG-1	Thalamus_2
AGCATCGTCGATAATT-1	Hippocampus
AGCCAAGCTTTGTGTC-1	Striatum
AGCCACTCCCGTGCTT-1	Cortex_3
AGCCCATACATGTAAG-1	Thalamus_2
AGCCCGGCATTAGAGG-1	Hypothalamus_1
AGCCCGGTAGCCTGTA-1	Lateral_ventricle
AGCCCTAAGCGAAGTT-1	Cortex_3
AGCCCTCCCTGGTGGC-1	Hypothalamus_1
AGCCGTGGCTAAATGT-1	Thalamus_1
AGCGACAGGAACGGTC-1	Hypothalamus_2
AGCGACATCCCATTCA-1	Fiber_tract
AGCGACCAACGATATT-1	Hippocampus
AGCGAGACGTGAAGGC-1	Hypothalamus_1
AGCGCATAATGAATCG-1	Striatum
AGCGCGGGTGCCAATG-1	Cortex_1
AGCGGACACTTCGTAG-1	Cortex_2
AGCGGGAAGGGTCCAT-1	Cortex_3
AGCGGGTCTGACACTC-1	Cortex_2
AGCGTACGAGAGCTAG-1	Cortex_1
AGCGTCTGAACCCGCA-1	Cortex_1
AGCGTGGTATTCTACT-1	Lateral_ventricle
AGCTAACAAGCAATGT-1	Hypothalamus_1
AGCTAGAAGCAGAAGT-1	Cortex_4
AGCTATTTAATCCAAC-1	Cortex_1
AGCTCCTTCGCACATC-1	Cortex_2
AGCTCTAGACGTTCCA-1	Lateral_ventricle
AGCTCTTCCCAGTGCA-1	Cortex_1
AGCTCTTTACTCAGTT-1	Thalamus_1
AGCTGAAGTAAACCAA-1	Cortex_1
AGCTGTAACCTCAATC-1	Hypothalamus_2
AGCTTATAGAGACCTG-1	Cortex_4
AGCTTGATCTTAACTT-1	Thalamus_2
AGGAAGCTGTCCGCCG-1	Cortex_2
AGGACAGTCGAATCCC-1	Cortex_2
AGGACATCGCACGTCG-1	Pyramidal_layer
AGGACGACCCATTAGA-1	Thalamus_1
AGGACGCTCGATGTTG-1	Cortex_5
AGGAGGCCTTCGCGCG-1	Cortex_2
AGGATAAAGTCGGGAT-1	Striatum
AGGATATAGGGATTTA-1	Cortex_3
AGGATCACGCGATCTG-1	Thalamus_2
AGGCAGATGCGTAAAC-1	Cortex_3
AGGCAGGGAGCGTACT-1	Fiber_tract
AGGCATTGTCGTAGGG-1	Cortex_2
AGGCCACCCGTTATGA-1	Hypothalamus_2
AGGCCCATTGTACAGG-1	Fiber_tract
AGGCCCTAGAACGCCA-1	Thalamus_2
AGGCCTGAGAATCTCG-1	Cortex_5
AGGCGGTTTGTCCCGC-1	Thalamus_2
AGGCTATGGTTAGCTT-1	Hippocampus
AGGCTTCCCGAAGAAG-1	Hypothalamus_2
AGGCTTGCTAGACACC-1	Hippocampus
AGGGAAACGAGGTACT-1	Cortex_4
AGGGACAGCACGGCGG-1	Cortex_4
AGGGACTCTACGCGAC-1	Fiber_tract
AGGGCAGCGGCGTGGT-1	Cortex_4
AGGGCGAGCAGCTGAT-1	Thalamus_2
AGGGCGTGATCGGCTA-1	Pyramidal_layer
AGGGCTGCAGTTACAG-1	Fiber_tract
AGGGTCGATGCGAACT-1	Cortex_1
AGGGTGCCGTTCTTTA-1	Hypothalamus_1
AGGGTGCTCTCGAGGG-1	Cortex_3
AGGGTTCCCTTTGGTT-1	Cortex_3
AGGGTTTAGTTCGGGA-1	Hippocampus
AGGTAACCTCCTATTC-1	Cortex_3
AGGTACGATATTGCCA-1	Cortex_1
AGGTAGATCGAGATAT-1	Hypothalamus_1
AGGTAGGTACAAAGCT-1	Thalamus_2
AGGTCAGGTGAGAGTG-1	Thalamus_2
AGGTGGTGACCTTCGC-1	Striatum
AGGTGTATCGCCATGA-1	Thalamus_2
AGGTTGAGGCACGCTT-1	Cortex_3
AGGTTTCACACACCTT-1	Fiber_tract
AGTAATGTCTTGCCGC-1	Fiber_tract
AGTACGGGCACCTGGC-1	Cortex_3
AGTACTCTTATGCCCA-1	Cortex_5
AGTAGGTAACATACAT-1	Cortex_3
AGTATAATACTAGGCA-1	Pyramidal_layer_dentate_gyrus
AGTATACACAGCGACA-1	Lateral_ventricle
AGTATCCATAATAACG-1	Cortex_1
AGTATGCTGGAGACCA-1	Hypothalamus_1
AGTATTTGGCACGACC-1	Lateral_ventricle
AGTCAAATGATGTGAT-1	Hypothalamus_1
AGTCAACACCACCATC-1	Thalamus_1
AGTCAAGATGACACTT-1	Cortex_3
AGTCACTAGCTCTCGA-1	Cortex_5
AGTCACTCCGCCTCAT-1	Cortex_1
AGTCAGCCACCGCCTG-1	Fiber_tract
AGTCCATTGGCTGATG-1	Cortex_1
AGTCCCGCCTTTAATT-1	Cortex_4
AGTCGACGGTCTCAAG-1	Cortex_3
AGTCGGCCCAAACGAC-1	Pyramidal_layer_dentate_gyrus
AGTCGGCTCAACTTTA-1	Thalamus_1
AGTCGTCGACCACCAA-1	Cortex_2
AGTCGTGGGCATTACG-1	Thalamus_1
AGTCTCACAAGACTAC-1	Hypothalamus_2
AGTCTTCTCCTCAAAT-1	Pyramidal_layer
AGTGAACAAACTTCTC-1	Cortex_4
AGTGACCTACTTTACG-1	Thalamus_1
AGTGACTGTGACACAA-1	Hypothalamus_1
AGTGAGACTTCCAGTA-1	Cortex_3
AGTGAGCCTCGCCGCC-1	Cortex_4
AGTGATAACCTGCGCG-1	Cortex_2
AGTGATATGAGTAGTT-1	Thalamus_1
AGTGATTCAAGCAGGA-1	Cortex_3
AGTGCACGCTTAAGAA-1	Cortex_2
AGTGCGTAGCTCGTAA-1	Thalamus_1
AGTGCTAAACACAGCA-1	Cortex_5
AGTGCTTGCACGAATA-1	Cortex_3
AGTGGCGGCAATTTGA-1	Cortex_1
AGTGGCGTCTGAAGGT-1	Cortex_2
AGTGTATTGCGCATTG-1	Cortex_4
AGTGTGGTCTATTGTG-1	Fiber_tract
AGTTAAACACTTGCGA-1	Thalamus_1
AGTTAAGCGGTCCCGG-1	Cortex_1
AGTTAAGTCAACCGCT-1	Thalamus_2
AGTTACTCTATCGTGG-1	Cortex_4
AGTTCCTACAGAATTA-1	Thalamus_1
AGTTCCTATTTATGTT-1	Fiber_tract
AGTTCTGCGTTGTATC-1	Hippocampus
AGTTGACATCGGCTGG-1	Cortex_3
AGTTGACGGTCCTTGC-1	Cortex_2
AGTTGCTGACTGATAT-1	Cortex_1
AGTTTCGCAGGTCGGA-1	Cortex_1
AGTTTGCACCTGCCTC-1	Cortex_2
AGTTTGGCACGGGTTG-1	Cortex_2
AGTTTGGCCAGACCTA-1	Thalamus_1
ATAAACCATTGGACGG-1	Cortex_5
ATAAACGGACCCGTAA-1	Fiber_tract
ATAAAGGCTCGGTCGT-1	Thalamus_1
ATAAATATTAGCAGCT-1	Thalamus_2
ATAACGCCGGAGGGTC-1	Striatum
ATAACGGAGTCCAACG-1	Fiber_tract
ATAAGGTGGAGAACAT-1	Striatum
ATAAGTTACCGCGACG-1	Hypothalamus_2
ATAATAGCTGTTGAAT-1	Fiber_tract
ATAATAGTGTAGGGAC-1	Fiber_tract
ATAATCTTGGAGAACC-1	Cortex_2
ATAATTAGCTAAGTAG-1	Cortex_2
ATACAGGCCCTCCAAT-1	Cortex_2
ATACCACGGGCAACTT-1	Thalamus_2
ATACCAGCAAATTGCT-1	Cortex_5
ATACCAGGCTAATAGA-1	Cortex_1
ATACCTAACCAAGAAA-1	Cortex_2
ATACGCCGATCTACCG-1	Cortex_4
ATACGCCGGCGAAACC-1	Fiber_tract
ATACGGAACGTCGTTT-1	Thalamus_2
ATACGGGTTTCGATTG-1	Cortex_3
ATACGTACTTAGCCAC-1	Cortex_2
ATACGTCCACTCCTGT-1	Cortex_3
ATACGTTATGCACGGA-1	Cortex_2
ATACTAGCATGACCCT-1	Pyramidal_layer
ATACTCTCGCCACTCT-1	Cortex_3
ATACTGCCTTACACCG-1	Cortex_5
ATAGACAACGGGACCT-1	Cortex_1
ATAGACGAAGAGAAAG-1	Thalamus_1
ATAGAGTACTGGGACA-1	Pyramidal_layer_dentate_gyrus
ATAGAGTTATCAACTT-1	Cortex_1
ATAGGCGGCTATAGAA-1	Thalamus_1
ATAGGCTAGCTTCGCA-1	Cortex_4
ATAGGGATATCCTTGA-1	Fiber_tract
ATAGGTTGGGCAGATG-1	Hippocampus
ATAGTCTTTGACGTGC-1	Cortex_4
ATAGTGAAGCGTTCTC-1	Hypothalamus_2
ATAGTTCCACCCACTC-1	Cortex_4
ATATAAAGCGCTCGTG-1	Cortex_2
ATATAAATGTAGCTGC-1	Cortex_2
ATATCAACCTACAGAG-1	Cortex_5
ATATCGTTCCTCGAAC-1	Cortex_2
ATATCTCCCTCGTTAA-1	Cortex_1
ATATCTTAGGGCCTTC-1	Hypothalamus_2
ATATGTCTCCCTAGCC-1	Cortex_1
ATATTCAGTTAAACCT-1	Thalamus_1
ATATTCCACATAGTGA-1	Cortex_2
ATATTCCCACAGGTCA-1	Cortex_1
ATATTGCTGTCAAAGT-1	Hippocampus
ATATTTAACCCTCAAG-1	Thalamus_1
ATCAAACACTGTTCCA-1	Lateral_ventricle
ATCAAACGAAGGTTTG-1	Thalamus_1
ATCAATCTGGGCTGCA-1	Hippocampus
ATCAATGCCGTGGCTG-1	Hypothalamus_1
ATCACATTAGAATATC-1	Cortex_1
ATCACGTGCTAATTAA-1	Thalamus_1
ATCACTTCATCCTCGC-1	Hippocampus
ATCAGACGGCACGCCG-1	Thalamus_1
ATCAGCCTCATGCTGC-1	Cortex_5
ATCAGTAGGCAGGGAT-1	Cortex_1
ATCATCCAATATTTGT-1	Hypothalamus_2
ATCCAACGCAGTCATA-1	Pyramidal_layer_dentate_gyrus
ATCCAATGGAGGGTCC-1	Thalamus_2
ATCCACATCGACAGAA-1	Cortex_2
ATCCAGAGCAACAACC-1	Hypothalamus_2
ATCCAGGATTCGTGAA-1	Thalamus_1
ATCCTACCTAAGCTCT-1	Thalamus_1
ATCCTGAATCGCTGCG-1	Thalamus_2
ATCCTGCGTGGAATGG-1	Thalamus_1
ATCCTGCTGCAGATAG-1	Cortex_4
ATCGACCCAATACAGA-1	Hypothalamus_2
ATCGACTCTTTCCGTT-1	Hippocampus
ATCGCACGATTGTTCA-1	Cortex_1
ATCGCACGCCGGGAGA-1	Hippocampus
ATCGCCAGTCAACATT-1	Cortex_5
ATCGGAGACAGACGGC-1	Cortex_2
ATCGGCAAGCAGTCCA-1	Cortex_4
ATCGTGGAAAGTCTGG-1	Hypothalamus_1
ATCTAATATCCTACGG-1	Cortex_2
ATCTAGCTTGTGAGGG-1	Cortex_5
ATCTCCCTGCAATCTA-1	Cortex_3
ATCTGACATGGAAGGA-1	Hypothalamus_1
ATCTGCACCTCTGCGA-1	Cortex_4
ATCTGCTGTTATCGCC-1	Lateral_ventricle
ATCTGGGCTGTTCTTG-1	Cortex_2
ATCTGGTTAAGACTGT-1	Fiber_tract
ATCTGTAATTGTACCC-1	Cortex_3
ATCTTGACCTGCAACG-1	Pyramidal_layer_dentate_gyrus
ATGAAGCCAAGGAGCC-1	Hippocampus
ATGACGCCGGCTCTAA-1	Fiber_tract
ATGACGCGTTCTATCC-1	Hypothalamus_2
ATGACTATCAGCTGTG-1	Lateral_ventricle
ATGACTATGCGACATT-1	Cortex_3
ATGAGGAGTGTTAATC-1	Pyramidal_layer_dentate_gyrus
ATGATCGGGAATAGAC-1	Hippocampus
ATGATGCAATGGTACA-1	Thalamus_1
ATGCACTACCGCATTG-1	Hippocampus
ATGCATGATCCAGGAT-1	Hippocampus
ATGCATTCCGTGATGG-1	Cortex_4
ATGCCATTTGCGACCA-1	Cortex_3
ATGCCGGTCTTGCATA-1	Fiber_tract
ATGCCGGTTGATGGGA-1	Cortex_1
ATGCGACAGTCCCATT-1	Fiber_tract
ATGCGAGTCCCACCAC-1	Cortex_2
ATGCTCAGTGTTGCAT-1	Pyramidal_layer
ATGCTCTGGCGCGGTA-1	Cortex_2
ATGGAGCAGGCCGTGA-1	Fiber_tract
ATGGATCCGGCGTCCG-1	Cortex_3
ATGGATTGACCAAACG-1	Hippocampus
ATGGCAGCATTACGAT-1	Hypothalamus_1
ATGGGACCTGCTGAAC-1	Hypothalamus_1
ATGGGCCTCGGCCTCT-1	Cortex_3
ATGGGTGTATACCTCC-1	Hypothalamus_1
ATGGTATTTACTGATT-1	Hypothalamus_1
ATGGTCGCGTGGTTTC-1	Cortex_2
ATGTACGATGACGTCG-1	Cortex_2
ATGTGAAAGCCTAATG-1	Thalamus_2
ATGTGCATCCGACGCA-1	Hippocampus
ATGTGGACATCTTGAT-1	Striatum
ATGTGTAGTTTAGTCA-1	Cortex_4
ATGTTACGAGCAATAC-1	Fiber_tract
ATGTTGTAGTCTGTTT-1	Lateral_ventricle
ATTAAACATGCGGACC-1	Hypothalamus_2
ATTAATACTACGCGGG-1	Hippocampus
ATTAATGAACCAGTCG-1	Cortex_3
ATTAATTCGGTCACTC-1	Cortex_3
ATTACAACTACCGGCC-1	Cortex_4
ATTACGCGCTGGCAGG-1	Thalamus_2
ATTACTAGCCTCTTGC-1	Hippocampus
ATTACTTACTGGGCAT-1	Cortex_4
ATTAGATTGATAGCGG-1	Hippocampus
ATTAGGCGATGCTTTC-1	Fiber_tract
ATTATACTTTGCTCGT-1	Cortex_1
ATTATCTCGACAGATC-1	Cortex_4
ATTATGCCATAGGGAG-1	Hippocampus
ATTATTATGTCCGTCA-1	Hypothalamus_1
ATTCACTGATGTTGGA-1	Cortex_2
ATTCAGGACCTATTTC-1	Cortex_5
ATTCAGTAGCAGGGTC-1	Lateral_ventricle
ATTCATATACTGTCCA-1	Fiber_tract
ATTCATCGTTGAGGCA-1	Cortex_2
ATTCCCACATAAACAA-1	Hippocampus
ATTCCTCCGCCAGTGC-1	Pyramidal_layer_dentate_gyrus
ATTCCTTCCAGGCGGT-1	Cortex_1
ATTCGACGCCGGGCCT-1	Thalamus_2
ATTCTCGTCTCTTTAG-1	Cortex_1
ATTCTTCGTACTTATG-1	Cortex_5
ATTGAAGATCTTAGTG-1	Thalamus_1
ATTGACGTAACTCGGT-1	Cortex_4
ATTGATAGCAACGAGA-1	Hippocampus
ATTGATGAGTCCTAAC-1	Cortex_1
ATTGCCTATTAGACCG-1	Hypothalamus_1
ATTGCGATCAGTAACT-1	Cortex_2
ATTGCTGCTCCTCCAT-1	Thalamus_1
ATTGGATTACAGCGTA-1	Cortex_5
ATTGGGAATATCTTGG-1	Cortex_3
ATTGTACAACTCGGCT-1	Cortex_5
ATTGTCGCAATACCTT-1	Cortex_1
ATTTAACTCGTATTAC-1	Cortex_3
ATTTACAGTTTACTGG-1	Thalamus_1
ATTTCATTATTTCGCG-1	Cortex_1
ATTTCCGGGTTCTGCG-1	Hypothalamus_2
ATTTGCGCGAGTAGCT-1	Hypothalamus_2
ATTTGTCTTGGGAGCT-1	Striatum
ATTTGTTCCAGGGCTC-1	Cortex_3
CAAACGAGTATCGCAG-1	Hypothalamus_2
CAAACGGTCGCACTTT-1	Thalamus_1
CAAACTACGATAGAGA-1	Cortex_4
CAAACTATTGAGCTTC-1	Cortex_1
CAAAGATTATTGGGCC-1	Thalamus_2
CAAATCTCTCACAAGG-1	Thalamus_2
CAAATGTCCTTCCGTG-1	Hypothalamus_2
CAAATTGTCAGCAAGC-1	Cortex_1
CAACGACCCGTTTACA-1	Hippocampus
CAACGGTTCTTGATAC-1	Hippocampus
CAACTATATCGAATGC-1	Cortex_1
CAACTCCTTGATCCCG-1	Hippocampus
CAACTGCTCATCCGAT-1	Striatum
CAACTTGTAGTGGGCA-1	Cortex_1
CAAGAGGGCGGAGTAC-1	Striatum
CAAGATATTATAACGT-1	Cortex_3
CAAGCAACGTCGGAGT-1	Thalamus_1
CAAGCACCAAATGCCT-1	Fiber_tract
CAAGCGGCACATAATT-1	Cortex_2
CAAGGATCGCATGTTC-1	Fiber_tract
CAAGTGAACTTTGGTT-1	Cortex_4
CAAGTGTGGTTGCAAA-1	Cortex_3
CAATAAACCTTGGCCC-1	Lateral_ventricle
CAATATTCTTGACCTA-1	Hypothalamus_1
CAATATTGGACTAGTG-1	Hippocampus
CAATCCCTATACCAGC-1	Cortex_4
CAATCCTGCCGTGGAG-1	Cortex_1
CAATGCGAGAAGTATC-1	Cortex_2
CAATGGATCTCTACCA-1	Cortex_3
CAATGGTCGGCCTGGG-1	Cortex_4
CAATTAAGGGTGATGA-1	Hippocampus
CAATTTCGTATAAGGG-1	Hypothalamus_2
CACAATGAGCTGCTAT-1	Thalamus_1
CACACAGGGATAGATT-1	Hippocampus
CACACGCGCTGTCTTA-1	Cortex_3
CACAGAGACGAGGACG-1	Hypothalamus_1
CACAGCACCCACGGCA-1	Hypothalamus_2
CACAGCTAGGGAGTGA-1	Pyramidal_layer
CACAGGGCCATATAGT-1	Cortex_5
CACAGGGCCGTTGTCA-1	Striatum
CACATAAGGCGACCGT-1	Cortex_5
CACATATTAGCAGGAT-1	Striatum
CACATCGTGCACGCGC-1	Hypothalamus_1
CACATCTCACCGACGA-1	Cortex_2
CACATGATTCAGCAAC-1	Hypothalamus_2
CACATGTTTGGACATG-1	Hippocampus
CACATTCTTTCGATGG-1	Cortex_1
CACCAGTCAGCATGCA-1	Hypothalamus_1
CACCATCGGAGGAGAC-1	Cortex_1
CACCCAAATCTTATGT-1	Cortex_5
CACCCACACGTCACCC-1	Pyramidal_layer
CACCCACGAGGCAATT-1	Cortex_1
CACCCGGTTTGTGACT-1	Hypothalamus_2
CACCCTAACAAGATCT-1	Cortex_2
CACCCTTGGTGAGACC-1	Thalamus_2
CACCCTTTCCTCGCTC-1	Cortex_1
CACCGATACACCGAGC-1	Cortex_4
CACCGCCAGAAGGTTT-1	Hippocampus
CACCGCCGACCAGCGA-1	Cortex_1
CACCGGTAGAGACATT-1	Hypothalamus_1
CACCGTATCCCATCCG-1	Cortex_5
CACCGTTAGGGATCAC-1	Hypothalamus_2
CACCGTTGCGCGATAT-1	Thalamus_1
CACCTAATAGAGTCGT-1	Fiber_tract
CACCTAATCAGTTTAC-1	Cortex_3
CACCTCGATGGTGGAC-1	Cortex_3
CACCTTGCGAAACTCG-1	Cortex_3
CACCTTGGCGCCTTTG-1	Cortex_4
CACGAAAGTTAGTCCC-1	Thalamus_2
CACGACTAAAGTTCTG-1	Cortex_4
CACGCACAGCGCAGCT-1	Lateral_ventricle
CACGCAGCGAGGCTTT-1	Thalamus_1
CACGCGGAACTGTTGC-1	Cortex_3
CACGTCGGCAACCTCT-1	Fiber_tract
CACGTTCGTGCTCTAG-1	Striatum
CACGTTTCGTACACAC-1	Cortex_2
CACTAAAGTTGCCTAT-1	Fiber_tract
CACTCAAGAGCTATGG-1	Fiber_tract
CACTCAGCTCTTGAGG-1	Cortex_1
CACTCCTATGTAAGAT-1	Hypothalamus_1
CACTCCTCTCGGTCGG-1	Cortex_4
CACTCGAGCTGAACAA-1	Striatum
CACTGACGATTGTGGA-1	Striatum
CACTGTCCAAGTGAGA-1	Hippocampus
CACTTAATCAGACGGA-1	Thalamus_1
CACTTCGCCACAGGCT-1	Pyramidal_layer
CAGAACTTAGCCCTCT-1	Cortex_5
CAGACACCGATCGCTG-1	Fiber_tract
CAGACCTGTAAGTGTT-1	Cortex_1
CAGACGAACCTGATAC-1	Hypothalamus_2
CAGAGACGGTCACCCA-1	Fiber_tract
CAGAGCATGAGCTTGC-1	Pyramidal_layer_dentate_gyrus
CAGAGGCGATGCATGA-1	Fiber_tract
CAGAGTGATTTAACGT-1	Cortex_1
CAGATACTAACATAGT-1	Pyramidal_layer_dentate_gyrus
CAGATATGAAGATGAC-1	Hypothalamus_1
CAGATCCTGGTTTGAA-1	Thalamus_2
CAGCAGCCCGTTCCTT-1	Fiber_tract
CAGCAGTCCAGACTAT-1	Cortex_2
CAGCAGTCTGTGCTGC-1	Cortex_2
CAGCCGGGCCCTCTAT-1	Cortex_4
CAGCCTCCTGCAGAGG-1	Cortex_3
CAGCCTCTCCTCAAGA-1	Cortex_5
CAGCGATTCCCTTCAA-1	Hypothalamus_2
CAGCTCACTGAGACAT-1	Thalamus_1
CAGCTCGACAAGTTAA-1	Cortex_1
CAGCTCGTGCTTGTGT-1	Hippocampus
CAGCTGGCGTAACCGT-1	Thalamus_1
CAGCTTAGTAGGTAGC-1	Thalamus_2
CAGGAAGACTTTATAT-1	Cortex_4
CAGGATATATCGTTGT-1	Hypothalamus_2
CAGGCCAGTACCACCT-1	Hypothalamus_1
CAGGCCGTTTGGGTGT-1	Thalamus_1
CAGGCGCACGGTGGTC-1	Hypothalamus_2
CAGGCGCCATGCTAGG-1	Striatum
CAGTAATCCCTCCCAG-1	Hippocampus
CAGTACCAGTTTACGT-1	Thalamus_2
CAGTAGCCCACGCGGT-1	Cortex_1
CAGTCGAGGATGCAAT-1	Cortex_4
CAGTCTCTCGGCTAAT-1	Cortex_1
CAGTCTGTATACTGGG-1	Fiber_tract
CAGTGAATAAATGACT-1	Cortex_3
CAGTGGTTGCACATGA-1	Hippocampus
CAGTGTCCGCAGAATG-1	Hippocampus
CAGTGTCGGCTGGCCC-1	Cortex_2
CAGTGTTAATCTCTCA-1	Hypothalamus_1
CAGTTCAAATTGACAC-1	Thalamus_1
CAGTTCCGCGGGTCGA-1	Hippocampus
CATAACGGACAGTCGT-1	Cortex_3
CATAAGAAGCTTGGCT-1	Cortex_2
CATAATGAGCGGGCGA-1	Cortex_4
CATACAAAGCCGAACC-1	Cortex_3
CATACACGGTTCCCAC-1	Striatum
CATACCCGTACCCAGT-1	Thalamus_2
CATACGAACTAGCTGG-1	Hypothalamus_1
CATACGGCGTCTGGGC-1	Hypothalamus_2
CATACGGGTGCATGAT-1	Cortex_1
CATACTATGTAATTGT-1	Thalamus_1
CATAGCCGCCCGGGAT-1	Hippocampus
CATAGCGTTGCCCACC-1	Hypothalamus_2
CATAGTACATTGAGAG-1	Cortex_1
CATAGTAGCATAGTAG-1	Hippocampus
CATAGTCCACAAGAAC-1	Thalamus_1
CATATAGGTACAGTCA-1	Hypothalamus_2
CATATGTCAGGCTACG-1	Thalamus_1
CATATTATTTGCCCTA-1	Cortex_4
CATCATCTACCCGGAC-1	Cortex_1
CATCATTACCCTGAGG-1	Cortex_2
CATCCAATATAGTTTG-1	Hypothalamus_1
CATCCTCTCAAAGATC-1	Cortex_2
CATCGCCCGCGGCCAA-1	Fiber_tract
CATCGGACGGGTTAAT-1	Hypothalamus_2
CATCTTACACCACCTC-1	Cortex_1
CATGAACCGACATTTG-1	Cortex_1
CATGAACCTCTTATCA-1	Cortex_5
CATGAGATGCACTCTC-1	Cortex_2
CATGATGCACAATTCT-1	Lateral_ventricle
CATGATGGAAGTTAGC-1	Cortex_4
CATGCATGGAGACCCT-1	Cortex_4
CATGCCAACTCGCAAA-1	Thalamus_2
CATGCGACCAGTTTAA-1	Cortex_4
CATGCGTTAGACAGAA-1	Cortex_3
CATGCTGGCTCCAATT-1	Cortex_1
CATGGATTGTCTTCCG-1	Cortex_5
CATGGCAGGAAGATCG-1	Hippocampus
CATGGGTATGCCTTAT-1	Cortex_2
CATGGGTCGGGTGTGG-1	Cortex_1
CATGGTAAGTAGCGTT-1	Striatum
CATGGTCTAGATACCG-1	Hippocampus
CATGTAAGAGACATTT-1	Cortex_2
CATGTCTCATTTATGG-1	Cortex_2
CATTACGTCGGCCCGT-1	Fiber_tract
CATTATCCCATTAACG-1	Hypothalamus_1
CATTATGCTTGTTGTG-1	Pyramidal_layer_dentate_gyrus
CATTCACTGACAGCTA-1	Cortex_5
CATTCAGGTCAGTGCG-1	Cortex_1
CATTCCCTAAGTACAA-1	Cortex_1
CATTTAGCGGACCATG-1	Cortex_3
CATTTCTAGCAGACTA-1	Fiber_tract
CATTTGAGTGGTACGT-1	Hypothalamus_2
CCAAACAGAACCCTCG-1	Hippocampus
CCAACCTTATGTAACT-1	Hypothalamus_1
CCAACGATGCACTGAT-1	Thalamus_1
CCAAGAAAGTGGGCGA-1	Fiber_tract
CCAAGACTTCTGCGAA-1	Hippocampus
CCAAGCGTAACTCGTA-1	Hippocampus
CCAAGGAACAGAGAGG-1	Fiber_tract
CCAATAGTGCCGTCGA-1	Thalamus_1
CCAATCGGTAGATCGA-1	Cortex_1
CCAATGTCACAGCAAG-1	Thalamus_1
CCAATTACGGGTCGAG-1	Cortex_4
CCAATTGAATGTTAAT-1	Hippocampus
CCACAATGTACGTCTT-1	Cortex_3
CCACACTGAGATATTA-1	Thalamus_1
CCACAGCTGAAATCAT-1	Cortex_1
CCACAGTACCCATCCT-1	Cortex_2
CCACCAACTTTACTGT-1	Hypothalamus_2
CCACCCAAGGAAAGTG-1	Lateral_ventricle
CCACGAGAAGAGAATC-1	Cortex_3
CCACGGAGCCATAAGA-1	Thalamus_1
CCACGGCAGGTGTAGG-1	Hypothalamus_1
CCACTAAACTGAATCG-1	Cortex_1
CCACTGGTGGCTGGTT-1	Fiber_tract
CCAGAAAGCAACTCAT-1	Hypothalamus_2
CCAGAGACAAAGCCGG-1	Hippocampus
CCAGATAGTTGAGTGA-1	Cortex_3
CCAGCCTGGACCAATA-1	Fiber_tract
CCAGCTACGCCTCATA-1	Cortex_1
CCAGCTCGAACGCATT-1	Cortex_2
CCAGCTGATGGTACTT-1	Fiber_tract
CCAGGGACGTGGCCTC-1	Pyramidal_layer_dentate_gyrus
CCAGTAGTCTGATCCA-1	Cortex_1
CCAGTCCATTATTCGA-1	Hippocampus
CCAGTCTAGACGGCGC-1	Cortex_1
CCAGTCTTGTCATAGA-1	Striatum
CCATAAACAACCCGAC-1	Cortex_1
CCATACCTTTACTTGT-1	Cortex_4
CCATAGGTTGGCGTGG-1	Fiber_tract
CCATAGTCAGTAACCC-1	Hippocampus
CCATCCATACCAAGTC-1	Fiber_tract
CCATCGCAGTTAAACT-1	Fiber_tract
CCATCTCACCAGTGAA-1	Cortex_1
CCATCTTGTTCACAAT-1	Cortex_1
CCATGCCCTAGATTTC-1	Cortex_5
CCATGCCTGTTTAGTA-1	Thalamus_1
CCATGCTCTGCAGGAA-1	Hippocampus
CCATGGCCCTTGTACC-1	Thalamus_2
CCATGTTCATCTATAT-1	Hypothalamus_1
CCATTAGCGATAATCC-1	Thalamus_1
CCATTCCCTGCCCACA-1	Thalamus_1
CCATTTCTACCTATTA-1	Cortex_2
CCCAAACATGCTGCTC-1	Cortex_3
CCCAACATACGTCGCG-1	Thalamus_1
CCCAACCACACTAACA-1	Cortex_4
CCCAAGACAGAGTATG-1	Cortex_4
CCCAATGAGATTTGCA-1	Hypothalamus_1
CCCAATTTCACAACTT-1	Thalamus_1
CCCAGTTAAGGCGCCG-1	Striatum
CCCGACCATAGTCCGC-1	Cortex_3
CCCGCAGCGCGAACTA-1	Lateral_ventricle
CCCGCAGGGCCCAAAG-1	Cortex_4
CCCGCCATGCTCCCGT-1	Hippocampus
CCCGCGCAATGCACCC-1	Fiber_tract
CCCGGGTCGTTCAGGG-1	Striatum
CCCGGTGGAAGAACCT-1	Pyramidal_layer
CCCGGTGTATCGGAAT-1	Thalamus_2
CCCGTAAGTCTAGGCC-1	Thalamus_2
CCCGTAGCTGGGAAGA-1	Hypothalamus_1
CCCGTCAGCGTCTGAC-1	Hippocampus
CCCTAGTGTCAGGTGT-1	Hippocampus
CCCTATGTAGAGCAGA-1	Hypothalamus_1
CCCTCAGATCGAGAAC-1	Hypothalamus_1
CCCTCATTCTGGAATT-1	Pyramidal_layer
CCCTCGATAATACACA-1	Hypothalamus_1
CCCTGAAATGAGTTGA-1	Thalamus_1
CCCTGCCCAATCCGCT-1	Thalamus_2
CCCTGCGCTACGCATA-1	Thalamus_2
CCCTGGTATGGGCGGC-1	Cortex_5
CCCTTTGACAGGTCTT-1	Fiber_tract
CCGAAAGTGGTGAGCA-1	Fiber_tract
CCGAACACTGGGCCTC-1	Thalamus_2
CCGAACCTTCCCGGCC-1	Striatum
CCGAAGTATATTGTTC-1	Fiber_tract
CCGACAAAGGGAGTGC-1	Thalamus_2
CCGACGGGCATGAGGT-1	Thalamus_2
CCGAGGGATGTTAGGC-1	Cortex_4
CCGATCTCAACCTTAT-1	Cortex_4
CCGATTCGAGGGACCC-1	Thalamus_2
CCGCACAAAGACCAAC-1	Lateral_ventricle
CCGCACGTGACCTCGG-1	Lateral_ventricle
CCGCATGTGGTACGAT-1	Cortex_2
CCGCCACCACAATCCA-1	Cortex_5
CCGCCGGTCAACACAC-1	Cortex_3
CCGCCTGCGAATTGGT-1	Lateral_ventricle
CCGCGGAATGCGTCAC-1	Hypothalamus_2
CCGCGGGTACGAAGAA-1	Thalamus_2
CCGCGTAGGTAAGGGC-1	Thalamus_2
CCGCTATCAGCACCAG-1	Hypothalamus_2
CCGCTGGTGCCATTCA-1	Cortex_5
CCGCTTACCTCACTCT-1	Thalamus_1
CCGGAATGGTTTCAGT-1	Pyramidal_layer_dentate_gyrus
CCGGAGCGTACTTTCT-1	Striatum
CCGGCGCATATTGGAT-1	Cortex_3
CCGGGACCCGCAGAGA-1	Hippocampus
CCGGGCGGTCTCGTCA-1	Fiber_tract
CCGGGCTAAGAATTTC-1	Hypothalamus_1
CCGGGCTGCTCCATAC-1	Cortex_3
CCGGGTTCGAGGTTAC-1	Thalamus_2
CCGGTTTGTAATTGTG-1	Hypothalamus_1
CCGTAAGTTGGTCCCA-1	Striatum
CCGTACCCAAGCGCCA-1	Cortex_3
CCGTATCTCGTCGTAG-1	Thalamus_2
CCGTGCCCATGACGGC-1	Cortex_3
CCGTGTTAAATTCCAT-1	Thalamus_1
CCGTTACGTTAGAACA-1	Cortex_1
CCGTTCCGAATCTCGG-1	Fiber_tract
CCTAAAGGCTGACGCT-1	Cortex_1
CCTAAATTAACGGTTC-1	Fiber_tract
CCTAACCCAAACAAGT-1	Cortex_3
CCTAACTAAGGCTCTA-1	Cortex_1
CCTACATTCACAGACG-1	Thalamus_1
CCTACGGCTCAGTCGA-1	Fiber_tract
CCTACTGCTTACACTT-1	Pyramidal_layer_dentate_gyrus
CCTAGGCGTAGCGATC-1	Cortex_3
CCTAGTTAGTCGCATG-1	Cortex_1
CCTATAATGAGTGCCC-1	Cortex_2
CCTATACCGTCCTGTC-1	Hypothalamus_2
CCTATATTTGTCCTGG-1	Striatum
CCTATCTATATCGGAA-1	Cortex_3
CCTATGGCTCCTAGTG-1	Hypothalamus_1
CCTATGGGTTACCGTC-1	Pyramidal_layer_dentate_gyrus
CCTCACCAATCTTGAC-1	Pyramidal_layer
CCTCACCTGAGGGAGC-1	Cortex_4
CCTCACCTTAGCATCG-1	Cortex_1
CCTCATGCAGCTACGA-1	Cortex_3
CCTCCCGACAATCCCT-1	Cortex_1
CCTCCGACAATTCAAG-1	Thalamus_1
CCTCGAAGTGGACGGG-1	Cortex_1
CCTCGCCAGCAAATTA-1	Cortex_3
CCTCGCGCGATATAGG-1	Cortex_4
CCTCGCGCTGTGCGAT-1	Striatum
CCTCGGACCGGGATAG-1	Cortex_3
CCTCGGTTTCCTTGCC-1	Hypothalamus_1
CCTCTAATCTGCCAAG-1	Fiber_tract
CCTCTACAAGGATTGG-1	Hypothalamus_1
CCTCTATCGATTAGCA-1	Thalamus_2
CCTCTCTCCCATCTAG-1	Thalamus_1
CCTCTGGCCTAGACGG-1	Cortex_1
CCTCTGTACTATTCTA-1	Striatum
CCTGAACGATATATTC-1	Striatum
CCTGAATATTTACATA-1	Lateral_ventricle
CCTGACCACCGATGGT-1	Fiber_tract
CCTGAGAATAAATGCA-1	Lateral_ventricle
CCTGCGATAGAACTGT-1	Hippocampus
CCTGCTATTTGAGAAG-1	Pyramidal_layer_dentate_gyrus
CCTGGCTAGACCCGCC-1	Thalamus_1
CCTGGTCGAATGTGGG-1	Cortex_2
CCTGTAAGACATGATA-1	Thalamus_1
CCTGTACTCACGCCCA-1	Thalamus_2
CCTGTCACCCGGGCTC-1	Pyramidal_layer_dentate_gyrus
CCTGTCGCCCGTAAAT-1	Thalamus_2
CCTGTTTGAAGACACG-1	Cortex_2
CCTTCAGTTAAAGTGA-1	Lateral_ventricle
CCTTCTTGATCCAGTG-1	Cortex_3
CCTTTAAGGGAGCACT-1	Fiber_tract
CCTTTCAATGAAGAAA-1	Cortex_1
CGAAACATAGATGGCA-1	Cortex_4
CGAAACGCAATTCATG-1	Thalamus_1
CGAACAGTATGGGCGT-1	Cortex_3
CGAACCCGCATGCGTC-1	Hypothalamus_2
CGAACGCCCAGTGCCG-1	Cortex_1
CGAAGTTGCTCTGTGT-1	Thalamus_1
CGAATCTGCTCGACGC-1	Hypothalamus_1
CGAATGAAGTCATTGC-1	Hypothalamus_1
CGAATGACGCATAATG-1	Striatum
CGACAATTTGATCTAA-1	Cortex_3
CGACACGCTCCGACAG-1	Cortex_3
CGACAGTTCGCGTTAT-1	Thalamus_1
CGACATGCGATCTTCT-1	Cortex_4
CGACTCAGGATGTTAT-1	Cortex_1
CGAGACCCTAGAGTGT-1	Hypothalamus_2
CGAGAGATGTGAACCT-1	Hippocampus
CGAGCACTTCAAGTTT-1	Pyramidal_layer
CGAGCGTTGATCAGCC-1	Cortex_3
CGAGCTGGGCTTTAGG-1	Cortex_3
CGAGGCCAGGCATTGG-1	Hippocampus
CGAGGCTAAATATGGC-1	Pyramidal_layer_dentate_gyrus
CGAGGGACTGCGGTCG-1	Striatum
CGAGGGTATCCAGGTG-1	Cortex_2
CGAGTACTAAAGAGGA-1	Thalamus_1
CGAGTGAAGGTACCAG-1	Hypothalamus_2
CGAGTGCTATAGTTCG-1	Cortex_1
CGAGTTCTGTCCCACC-1	Cortex_3
CGAGTTTATCGGACTG-1	Cortex_3
CGATACCTCGCGGACA-1	Thalamus_1
CGATATTAGCCGCAGG-1	Cortex_1
CGATCCGACCCAGTGC-1	Thalamus_1
CGATCCTCGCAACATA-1	Hypothalamus_1
CGATCTGTTGGAGGAC-1	Thalamus_2
CGATGGACCCTACGCC-1	Cortex_4
CGATTAAATATCTCCT-1	Striatum
CGATTCGCCTGGCTGC-1	Cortex_2
CGCAAACACGAGTTAC-1	Hippocampus
CGCAATTACTTTCGGT-1	Hippocampus
CGCAATTAGGGTAATA-1	Fiber_tract
CGCAATTCTACAATAA-1	Hippocampus
CGCACATGTCCACTAC-1	Cortex_3
CGCACGTCTGTTTATG-1	Hypothalamus_1
CGCACGTGCGCTATCA-1	Cortex_1
CGCAGAAACATTTGCG-1	Cortex_1
CGCAGGCGATCCAAAC-1	Cortex_5
CGCATCATGGCTTCAG-1	Cortex_5
CGCATGGTGCGATGCT-1	Fiber_tract
CGCATTAGCTAATAGG-1	Hippocampus
CGCCAAGAAGCCGAGT-1	Thalamus_2
CGCCACCCGCATTAAC-1	Hippocampus
CGCCATCCGATTATGA-1	Cortex_3
CGCCCAGCACGCCTAG-1	Lateral_ventricle
CGCCCGCTTCCGTACA-1	Cortex_1
CGCCCTTGAAGGCTGA-1	Pyramidal_layer
CGCCGCCCATGCCTGT-1	Striatum
CGCCTCCCTCCTCTAT-1	Lateral_ventricle
CGCCTGGCCTACGTAA-1	Thalamus_2
CGCGACCGCGACAGAT-1	Cortex_2
CGCGAGTCTGCCGGGT-1	Thalamus_2
CGCGCAAATGTCCAGA-1	Thalamus_2
CGCGCAAGGAACTACA-1	Cortex_1
CGCGCATGTTTGATTG-1	Fiber_tract
CGCGCCCGACTTAATA-1	Cortex_3
CGCGGCTCAACTTGAA-1	Cortex_3
CGCGGGAATTAGGCAG-1	Fiber_tract
CGCGTTCATGAAATAC-1	Pyramidal_layer_dentate_gyrus
CGCTACGGGACATTTA-1	Thalamus_1
CGCTAGAGACCGCTGC-1	Cortex_4
CGCTATACCGCCCACT-1	Fiber_tract
CGCTATTCAATGTATG-1	Hippocampus
CGCTATTCTTAGGCTC-1	Hypothalamus_2
CGCTCGACATAATGAT-1	Hippocampus
CGCTCTCCGTAGATTA-1	Thalamus_1
CGCTGAGGACGTCCAA-1	Cortex_5
CGCTGGTGACTACCCT-1	Cortex_2
CGCTGTGACGCCGCAC-1	Pyramidal_layer_dentate_gyrus
CGCTGTGTGGATGTTG-1	Hypothalamus_1
CGCTTAGTATTGATAC-1	Lateral_ventricle
CGCTTATTCCCGGTCG-1	Thalamus_2
CGCTTCCACTGAAATC-1	Hippocampus
CGCTTTCATACCGGTG-1	Fiber_tract
CGCTTTCTTGCATTCG-1	Cortex_3
CGGAAAGAATCAAACG-1	Fiber_tract
CGGAACGTAAACATAG-1	Fiber_tract
CGGAGCAATTTAATCG-1	Striatum
CGGAGCATGGCGATCC-1	Fiber_tract
CGGAGCTTATAACACC-1	Cortex_4
CGGAGTTTGAGAGACA-1	Thalamus_1
CGGATAAGCGGACATG-1	Fiber_tract
CGGATCCTCAAGGACT-1	Cortex_2
CGGATGAATGCTGTGA-1	Hypothalamus_1
CGGCAAACATCGTGCG-1	Striatum
CGGCACCGTTAGCGCC-1	Cortex_4
CGGCACTCAAGAAAGT-1	Cortex_3
CGGCAGGGTCGGGTTG-1	Cortex_1
CGGCCACGCACAAAGT-1	Hypothalamus_2
CGGCCCAGGTATATCC-1	Cortex_5
CGGCGCCATCAATCCC-1	Cortex_2
CGGCTTTGTATGATAA-1	Cortex_1
CGGGAATATAGTATAC-1	Cortex_5
CGGGAATTTATGTAAA-1	Fiber_tract
CGGGAGCTTCAGTGTA-1	Cortex_2
CGGGATCAATGTAAGA-1	Hippocampus
CGGGCAGCTAAACCGC-1	Thalamus_1
CGGGCCATAGCCGCAC-1	Cortex_1
CGGGCCTTCTTTGTAA-1	Thalamus_1
CGGGTGTACCCATTTA-1	Cortex_3
CGGTACTAGAATCAAA-1	Striatum
CGGTAGAGGTGCAGGT-1	Cortex_1
CGGTCAAGTGGGAACC-1	Cortex_3
CGGTCCGTCGCAAGCC-1	Striatum
CGGTCTATCAACCCGT-1	Cortex_1
CGGTGAAGACTAAAGT-1	Hypothalamus_2
CGGTGCAGATAGAACG-1	Thalamus_1
CGGTGCGCGTTGGTCC-1	Hypothalamus_2
CGGTGTACTTGATCCC-1	Fiber_tract
CGGTTATCCAACAGTG-1	Cortex_1
CGGTTCAAGTAGGTGT-1	Cortex_4
CGGTTCCGGCTTCTTG-1	Cortex_3
CGGTTGACCTGGCATA-1	Thalamus_2
CGGTTGAGTATCCTTC-1	Hypothalamus_1
CGTAAACGCTTGAGTG-1	Cortex_1
CGTAAAGCAAGAAATC-1	Hypothalamus_1
CGTACCTGATAGGCCT-1	Hippocampus
CGTAGCGAATTGTCAG-1	Cortex_1
CGTAGCGCCGACGTTG-1	Cortex_1
CGTATTAAGAGATCTA-1	Thalamus_1
CGTCACGTCCATTGGT-1	Hypothalamus_2
CGTCAGTGCGCACAAG-1	Cortex_3
CGTCATACCATATCCA-1	Fiber_tract
CGTCGCTTGGTTATAC-1	Hypothalamus_1
CGTCGGATAGTGTTGA-1	Cortex_1
CGTCGGGTCTAAGCGC-1	Thalamus_2
CGTCGTCCTTCGCGAA-1	Cortex_2
CGTCTGGAAGGGCCCG-1	Cortex_3
CGTGAAGTTAATTCAC-1	Thalamus_1
CGTGACATTGGGTCGT-1	Cortex_1
CGTGACCAGTCCTCTG-1	Striatum
CGTGCAGACTGGGACA-1	Lateral_ventricle
CGTGCATTGTCGACGC-1	Thalamus_2
CGTGCCCTCCCGAAGA-1	Striatum
CGTGCTTCTACCTAAA-1	Hypothalamus_1
CGTGGCCGAATATCTA-1	Cortex_2
CGTGGTACCCAAAGGC-1	Hypothalamus_1
CGTGTCCCATTCGCGA-1	Hippocampus
CGTGTCTCGTTACGAC-1	Hypothalamus_1
CGTTAATGTCCCGACG-1	Cortex_5
CGTTAGCTCACAACTG-1	Cortex_4
CGTTCAGACCCGCGAA-1	Cortex_2
CGTTCATGGTGCGCGT-1	Thalamus_2
CGTTGAATACCGCGCT-1	Cortex_2
CGTTGAGCGACCGTCG-1	Striatum
CGTTGCCCGCGTGGGA-1	Lateral_ventricle
CGTTGTCGGCAATTGA-1	Cortex_2
CGTTGTTTCAATTCCC-1	Thalamus_1
CGTTTAAGCGGAGCAC-1	Cortex_3
CGTTTCACTTCGGGCG-1	Cortex_4
CGTTTCGCTCATTACA-1	Thalamus_1
CGTTTGTGTAGAGGGT-1	Hypothalamus_1
CTAAACGGGTGTAATC-1	Cortex_4
CTAAAGAATGCCTACT-1	Thalamus_1
CTAAAGGGAAATAGGA-1	Hypothalamus_2
CTAAAGTCCGAAGCTA-1	Cortex_4
CTAAATCCGGTGTACA-1	Hypothalamus_1
CTAAATCCTATTCCGG-1	Cortex_1
CTAACCGCGCGCCCGT-1	Thalamus_1
CTAACGAAACTTGCTG-1	Cortex_1
CTAACTGGTCCGGTTC-1	Thalamus_1
CTAAGGGAATGATTGG-1	Lateral_ventricle
CTAATTCGCACGCGCT-1	Fiber_tract
CTAATTTCAACAACAC-1	Hippocampus
CTACAAGAAATAACCC-1	Hypothalamus_1
CTACACTAGCTTGTTC-1	Cortex_5
CTACCCTAAGGTCATA-1	Cortex_1
CTACGACTAGCTATAA-1	Thalamus_2
CTACGATCCTATCCTA-1	Hypothalamus_1
CTACGCACGGAGTACC-1	Thalamus_1
CTACGCCATTTCCGAT-1	Cortex_4
CTACGTGTTGCCACCA-1	Cortex_1
CTACTATCATAGGTTT-1	Thalamus_2
CTACTATCTTTCAGAG-1	Cortex_1
CTACTCAAGGTATAGT-1	Hypothalamus_1
CTACTCTAGGCCCGGC-1	Thalamus_2
CTACTGCCACCTGACC-1	Hippocampus
CTAGATAAACTCCTCG-1	Cortex_1
CTAGATGTGAGTGTAA-1	Cortex_5
CTAGATTTACGACGGC-1	Lateral_ventricle
CTAGCAACTAATTTAC-1	Cortex_5
CTAGCATAGTATAATG-1	Fiber_tract
CTAGCCGATGTTATGA-1	Cortex_5
CTAGGCGCCCTATCAG-1	Cortex_3
CTAGGTCTGAAGGAAT-1	Cortex_5
CTAGGTTCGGACGTGA-1	Cortex_2
CTAGTAGAAAGGGATT-1	Cortex_2
CTAGTATTCGGAATTA-1	Cortex_1
CTAGTCACGTCTTAAG-1	Fiber_tract
CTAGTGAAGGACAGGA-1	Thalamus_1
CTAGTTACAACCCGGT-1	Striatum
CTAGTTGGGCCCGGTA-1	Pyramidal_layer_dentate_gyrus
CTATAAGAGCCAATCG-1	Cortex_4
CTATAGGCGTTGATGT-1	Hypothalamus_1
CTATATCCAGCCTGGC-1	Hypothalamus_1
CTATCGACGAAATACA-1	Cortex_2
CTATCGGGTCTCAACA-1	Fiber_tract
CTATGAACACCTTGCC-1	Hypothalamus_1
CTATGCCCGAATGCAA-1	Striatum
CTATGTCACTAGCCCA-1	Pyramidal_layer_dentate_gyrus
CTATGTCTATTGAAAC-1	Cortex_1
CTATGTGAGTCACGGC-1	Thalamus_2
CTATTCATGTGTCCCA-1	Striatum
CTATTTGGTTACGGAT-1	Striatum
CTCAAACCACTGCCCG-1	Hypothalamus_1
CTCAACTAACCCGGAT-1	Lateral_ventricle
CTCACATTTACTAAAT-1	Cortex_2
CTCACTGTGATACTTA-1	Cortex_2
CTCACTTGGCTGGTAA-1	Thalamus_2
CTCAGGACTCACCTGT-1	Fiber_tract
CTCAGTCACGACAAAT-1	Cortex_1
CTCATGGCTCACAATC-1	Cortex_1
CTCATGGTAATTTGCG-1	Thalamus_1
CTCATTGCTCTAACAA-1	Cortex_2
CTCATTTGATGGGCGG-1	Pyramidal_layer
CTCCCTCCTTTCGATC-1	Thalamus_1
CTCCGCCCACATGAGG-1	Thalamus_1
CTCCGGCCTAATATGC-1	Hippocampus
CTCCGGCTTGTAGACA-1	Hippocampus
CTCCTAAGTTATGTCT-1	Cortex_3
CTCCTCCAGCTCACAC-1	Striatum
CTCGAGGCAAGTTTCA-1	Hypothalamus_1
CTCGAGGTCGAACAGT-1	Pyramidal_layer_dentate_gyrus
CTCGATATTTGCGAGC-1	Cortex_4
CTCGCACCTATATAGT-1	Hippocampus
CTCGCCGAATGTAGGG-1	Cortex_2
CTCGGGTTCTCTGGCC-1	Hypothalamus_1
CTCGGTACCACTGCTC-1	Striatum
CTCGGTCCGTAGCCTG-1	Pyramidal_layer
CTCGGTTGTCGGCCCT-1	Fiber_tract
CTCGTCGAGGGCTCAT-1	Hypothalamus_1
CTCGTTACGGCTACCA-1	Lateral_ventricle
CTCTACACTGGCGATT-1	Thalamus_2
CTCTATTTGGCTGCAG-1	Lateral_ventricle
CTCTCACAATCGATGA-1	Hippocampus
CTCTCGATGTGCGCCT-1	Cortex_5
CTCTCTAACTGCCTAG-1	Thalamus_2
CTCTGCAGGCATTCTT-1	Hypothalamus_1
CTCTGCGAAGCAAGCA-1	Cortex_3
CTCTGGACGCCTGGTG-1	Hippocampus
CTCTGTGCCTGCTATG-1	Cortex_5
CTCTGTTTGAGGATTC-1	Cortex_1
CTCTTCTATTGACTGG-1	Cortex_2
CTCTTCTGGAAGTTAG-1	Hypothalamus_1
CTCTTGTCCCGCTTGG-1	Striatum
CTGAAAGAGATCCGAC-1	Cortex_3
CTGAATCCGAGACCTC-1	Fiber_tract
CTGACTGCGCAGCTCG-1	Cortex_4
CTGAGCAAGTAACAAG-1	Cortex_3
CTGATCCCTTTATGCA-1	Hypothalamus_1
CTGCACAACTACATAT-1	Cortex_2
CTGCACCTGGAACCGC-1	Hippocampus
CTGCACTCCAGTACAG-1	Cortex_2
CTGCCAAGGTTGGAAG-1	Cortex_3
CTGCCATGCATCACAT-1	Hypothalamus_2
CTGCCTAGCCACCAAG-1	Cortex_5
CTGCCTTTAATACCTT-1	Hypothalamus_1
CTGCGGGTGAAATGTT-1	Thalamus_2
CTGCGGTAGTCACGTG-1	Cortex_5
CTGCGTTACGATATAA-1	Cortex_4
CTGCTGAGGCCACGAA-1	Thalamus_1
CTGCTTGGCGATAGCT-1	Cortex_2
CTGGAAATGGATGCTT-1	Thalamus_1
CTGGAAGACACGGTGG-1	Cortex_3
CTGGATTTACACTTGA-1	Fiber_tract
CTGGCATCCGAATGAG-1	Thalamus_1
CTGGCGACATAAGTCC-1	Cortex_1
CTGGCGCACAGGTCTG-1	Cortex_3
CTGGCGGGAATAAGTA-1	Fiber_tract
CTGGCTCCTGCGGGAT-1	Cortex_1
CTGGCTGATTCATCCT-1	Cortex_3
CTGGCTGCTAACGTAA-1	Cortex_1
CTGGCTGGTTGTCAGT-1	Fiber_tract
CTGGGATAAATAATGG-1	Striatum
CTGGGCCTGCTATATC-1	Thalamus_2
CTGGGTAGGCAGTTAA-1	Striatum
CTGGTAACACATAGAA-1	Cortex_3
CTGGTAACGAGCTCTT-1	Cortex_1
CTGGTCCTAACTTGGC-1	Cortex_4
CTGGTGAATGGGCCTA-1	Hypothalamus_1
CTGGTTCAACGCATCA-1	Cortex_1
CTGGTTTCGAGCAAGA-1	Cortex_2
CTGTACTTCTTAGCAT-1	Thalamus_1
CTGTAGCCATCTCACT-1	Fiber_tract
CTGTATGGTGTAGAAA-1	Pyramidal_layer
CTGTCAAATGGCTCGG-1	Cortex_3
CTGTGCAGGGTAGGTC-1	Lateral_ventricle
CTGTGGTCGGGAGATA-1	Cortex_2
CTGTTACCCAATCTAG-1	Fiber_tract
CTGTTCACTGCCTGTG-1	Hippocampus
CTGTTCATCTCACGGG-1	Hippocampus
CTGTTGTTCAGTCGTA-1	Hypothalamus_1
CTTAACTTCGAAGTAC-1	Cortex_1
CTTACACGGTATTCCA-1	Thalamus_1
CTTACACTGGGAAATA-1	Hippocampus
CTTAGCCTTCCACATG-1	Cortex_3
CTTAGGTATAGACCAG-1	Hypothalamus_1
CTTAGTAGGCCTACAG-1	Cortex_4
CTTAGTGTAGTAGCAT-1	Cortex_2
CTTAGTTGAGGAATCG-1	Hypothalamus_1
CTTATGTTGACTACCA-1	Cortex_3
CTTCAACTCCACTTGG-1	Cortex_2
CTTCACGCCCTGGTAC-1	Hypothalamus_1
CTTCAGTGGTCGCCTA-1	Thalamus_2
CTTCATAGCTCAAGAA-1	Hippocampus
CTTCATTGTCAGTGGA-1	Thalamus_2
CTTCCGCTCCGTGAAG-1	Fiber_tract
CTTCGTAGATAGGTGA-1	Thalamus_1
CTTCTATGTTGAAGTA-1	Thalamus_2
CTTCTATTAATGCTAG-1	Hypothalamus_2
CTTCTGGGCGTACCTA-1	Hypothalamus_1
CTTCTTACGTCGTATA-1	Cortex_3
CTTGACCCGAAAGATA-1	Cortex_1
CTTGAGGTTATCCCGA-1	Cortex_1
CTTGAGTTAGGGTAAT-1	Cortex_3
CTTGCAACCGCCTCCT-1	Thalamus_2
CTTGCCCAGGCTCTAC-1	Hypothalamus_2
CTTGGCCAAGCTGGGA-1	Striatum
CTTGTACTTGTTGACT-1	Hippocampus
CTTGTCAACATTCGAG-1	Striatum
CTTGTGAGTCTTTGAC-1	Cortex_3
CTTGTGCTCACCGATT-1	Cortex_1
CTTGTTGCTGAGTCAA-1	Striatum
CTTGTTTATGTAGCCA-1	Fiber_tract
CTTTAACTTTCAAAGG-1	Pyramidal_layer_dentate_gyrus
CTTTAATATTGGTCGA-1	Cortex_2
CTTTACCGAATAGTAG-1	Cortex_2
CTTTAGGAACACTGTT-1	Cortex_3
CTTTAGTGCTATTATT-1	Hypothalamus_2
CTTTCTGTGCGGGCTT-1	Striatum
CTTTGGCGCTTTATAC-1	Thalamus_2
CTTTGGCTTTAGTAAA-1	Thalamus_1
CTTTGGGATTGTTGCA-1	Hypothalamus_1
GAAACAGATGACCACC-1	Cortex_3
GAAACAGCCATGCAGT-1	Cortex_3
GAAACATAGGAAACAG-1	Hypothalamus_1
GAAACCGAATTACCTT-1	Hypothalamus_2
GAAACCTATACAAATG-1	Striatum
GAAACTCGTGCGATGC-1	Lateral_ventricle
GAAACTCTAATGAAGG-1	Cortex_1
GAAAGAACAGCGTTAT-1	Cortex_4
GAAAGCAGTGCACTTT-1	Fiber_tract
GAAAGCCCTTTGGACC-1	Thalamus_2
GAAAGTGACTAACTGC-1	Hippocampus
GAAATACTAAACGTTT-1	Fiber_tract
GAAATATCACCATCAG-1	Thalamus_2
GAAATCGCGCGCAACT-1	Cortex_3
GAAATGGCGGTGTTAG-1	Thalamus_1
GAAATGGGATGTAAAC-1	Hippocampus
GAAATTAGCACGGATA-1	Cortex_4
GAAATTCACATCGCTG-1	Cortex_3
GAAATTGTCTCTATAA-1	Thalamus_1
GAACACACATCAACCA-1	Hippocampus
GAACAGATTACTAAAT-1	Cortex_2
GAACCATCTGGGAGAC-1	Cortex_5
GAACCCTCTGTGTTCT-1	Cortex_2
GAACCTTTAACGATCC-1	Cortex_2
GAACGACCGAATGATA-1	Hippocampus
GAACGTCTCATGGTCG-1	Cortex_3
GAAGAAACGATATTGT-1	Hypothalamus_1
GAAGAACGGTGCAGGT-1	Fiber_tract
GAAGCCACTGATTATG-1	Cortex_2
GAAGCCTGCACATTCC-1	Striatum
GAAGCGTGAGGAATTT-1	Thalamus_1
GAAGCTCGGACCCGTC-1	Thalamus_2
GAAGCTTGCTGACCGC-1	Thalamus_1
GAAGGAGTCGAGTGCG-1	Cortex_2
GAAGTCAGTTGCACTA-1	Fiber_tract
GAAGTCTCCCTAGCGA-1	Cortex_3
GAAGTGATTTATCGTG-1	Thalamus_1
GAAGTGCTGGATAGCT-1	Cortex_3
GAAGTTTCCACTCAAT-1	Thalamus_1
GAATAGACGCGACCCA-1	Cortex_3
GAATAGTGCTCGATTA-1	Hypothalamus_1
GAATATTCGGAGTCCC-1	Cortex_1
GAATCGACATGGTCAC-1	Pyramidal_layer_dentate_gyrus
GAATCGCCGGACACGG-1	Cortex_1
GAATCTGAACATTCTC-1	Hypothalamus_2
GAATGCCGAAATGACC-1	Fiber_tract
GAATGCGAATCGGTTC-1	Cortex_2
GAATGTATGGCAGGTC-1	Cortex_4
GAATGTGGTCCGGATT-1	Striatum
GAATGTTGGGTAATCT-1	Hippocampus
GAATTATAGTGAAAGG-1	Fiber_tract
GAATTCACCCGGGTGT-1	Fiber_tract
GAATTTCTCGCTGCAG-1	Lateral_ventricle
GACAAACATATGCAGG-1	Cortex_2
GACAACGACCATTGAA-1	Fiber_tract
GACAACGCAGCTTACG-1	Hippocampus
GACACAAGGGAAGAAA-1	Hippocampus
GACACGAGTTAGAGGA-1	Fiber_tract
GACACTGAGTTCAGTG-1	Thalamus_1
GACAGCCAGACCTGAC-1	Cortex_2
GACAGGCACACACTAT-1	Fiber_tract
GACATCCGTCGAACTG-1	Cortex_2
GACATCGATTTATAAC-1	Fiber_tract
GACCAGAGCCCTGTAG-1	Thalamus_1
GACCCAATTATGATAC-1	Thalamus_2
GACCCGTCGCCGGCTA-1	Cortex_1
GACCGACTGAAGCGTC-1	Thalamus_2
GACCGATTAAATATGT-1	Hypothalamus_1
GACCGTCAGGTCGTGA-1	Cortex_1
GACCGTGCTGACGGTG-1	Thalamus_1
GACCTTCCACGTCTAC-1	Cortex_5
GACGACGATCCGCGTT-1	Cortex_2
GACGCCGTAAAGGCTA-1	Fiber_tract
GACGCCTGTTGCAGGG-1	Cortex_3
GACGCTTGCTTCTAAA-1	Thalamus_1
GACGGACCGCGTTCCT-1	Cortex_5
GACGGGTTGGCCCGTA-1	Striatum
GACGGTCAATAGAAGC-1	Cortex_4
GACGTGAGACTCCATG-1	Cortex_1
GACTAAGATCATGCAC-1	Hippocampus
GACTAAGTAGGCTCAC-1	Hippocampus
GACTACAAAGCGGTGG-1	Thalamus_1
GACTACAATTGCTCGT-1	Cortex_5
GACTCACCCACGTGAG-1	Cortex_5
GACTCGCGGGAATGAC-1	Cortex_1
GACTGCAAATCGAGCT-1	Cortex_2
GACTGCACCAGCCCAG-1	Cortex_2
GACTGCTGGTGAGAAA-1	Hypothalamus_1
GAGACTGATGGGTAGA-1	Pyramidal_layer_dentate_gyrus
GAGACTTCGCGACCGA-1	Fiber_tract
GAGAGGGCGCGAGGTT-1	Thalamus_1
GAGAGGTGCATTCTGG-1	Thalamus_2
GAGATCTGCTTGGCAT-1	Thalamus_1
GAGATCTGTCACTCCG-1	Hippocampus
GAGATCTTCCATGACA-1	Striatum
GAGATGGGAGTCGACA-1	Cortex_2
GAGCACCTGTGTCCAG-1	Cortex_2
GAGCATCAACAACTTG-1	Hypothalamus_1
GAGCATCATCCCTGGG-1	Cortex_3
GAGCCACGGTAGTAGG-1	Cortex_1
GAGCCAGCTACCTGTG-1	Cortex_2
GAGCGAGGGAGTACCG-1	Cortex_3
GAGCGCGCACGAGTAG-1	Cortex_2
GAGCGCTGTTAGGTAA-1	Hypothalamus_1
GAGCTAAGGGCATATC-1	Cortex_3
GAGCTCTCGGACCTAA-1	Fiber_tract
GAGGAATGGAGAGGTT-1	Hippocampus
GAGGCCCGACTCCGCA-1	Hypothalamus_1
GAGGCTATCAAAGTCG-1	Thalamus_2
GAGGGAGTCAGATCGC-1	Hypothalamus_1
GAGGGCATCGCGTATC-1	Cortex_3
GAGGGCGCAGCTCTGC-1	Cortex_1
GAGGGTAGTAACAAAG-1	Hypothalamus_1
GAGGTACATCCATCTT-1	Cortex_1
GAGGTACGCGTGTCCC-1	Cortex_5
GAGGTCCCAAAGATCT-1	Fiber_tract
GAGTACGGGTATACAA-1	Hippocampus
GAGTAGATACTAGTTG-1	Cortex_2
GAGTATACCCTAATCA-1	Hypothalamus_1
GAGTATGCCCGCCTTG-1	Hypothalamus_2
GAGTATGCGCGTGCAT-1	Cortex_2
GAGTCAGACCAGAATC-1	Fiber_tract
GAGTCCGCTTACCGGA-1	Fiber_tract
GAGTGTCAACCAGAAA-1	Cortex_2
GAGTGTGCGGTACCCA-1	Cortex_3
GAGTTGATGGCAATTT-1	Thalamus_2
GATAAATCGGTGGATG-1	Hippocampus
GATAACTCGCACTGTG-1	Cortex_3
GATAAGGCAGATGCAA-1	Cortex_3
GATACGATGGGAGTCA-1	Thalamus_1
GATAGGTAACGTTGAC-1	Fiber_tract
GATATCTCATGCAATA-1	Cortex_1
GATATGAGACACTAAC-1	Striatum
GATATGCGGTAGCCAA-1	Cortex_1
GATATGGATTACGCGG-1	Lateral_ventricle
GATATTGAGATTGGCG-1	Cortex_4
GATATTTCCTACATGG-1	Cortex_1
GATCAACATAAAGGGA-1	Hypothalamus_1
GATCATTCCAAACATT-1	Thalamus_1
GATCCCTTTATACTGC-1	Hippocampus
GATCCGGGAATTAACA-1	Lateral_ventricle
GATCCTAAATCGGGAC-1	Cortex_1
GATCCTCGACACTGGC-1	Thalamus_1
GATCGACACTATCTGA-1	Pyramidal_layer_dentate_gyrus
GATCGCGGGCTCTCCA-1	Thalamus_1
GATCGCTACCCGATTT-1	Cortex_2
GATCGCTATATCTCAG-1	Hypothalamus_1
GATCGCTGTGGTGCGT-1	Hypothalamus_1
GATCGGTGGCCATAAC-1	Pyramidal_layer_dentate_gyrus
GATCGTGACTGATATC-1	Lateral_ventricle
GATCTGCTATCTAAGG-1	Striatum
GATCTTGGAGGGCATA-1	Lateral_ventricle
GATCTTTGCAGGGTAT-1	Thalamus_1
GATGACAAGTAGGGCA-1	Hypothalamus_2
GATGCCAGCAGAAGGC-1	Hippocampus
GATGCGTCCTGCATTC-1	Hypothalamus_2
GATGCTACAAGCGCCT-1	Pyramidal_layer
GATGCTGTATTTCATC-1	Striatum
GATGGCGCACACATTA-1	Hippocampus
GATGGTGCCCTAGGCA-1	Cortex_4
GATGTAACGAACCACC-1	Thalamus_2
GATGTCCGGATCACAT-1	Cortex_1
GATGTCGGTCAACTGC-1	Cortex_4
GATGTTCAATCCACGA-1	Thalamus_1
GATGTTTGTGCGAGAT-1	Pyramidal_layer
GATTAACCGAAAGCCC-1	Cortex_2
GATTACTGAATTTGGG-1	Thalamus_1
GATTCCCTTGTCGCAG-1	Pyramidal_layer_dentate_gyrus
GATTCCGCGTTTCCGT-1	Cortex_1
GATTCCTATACGGCGC-1	Hippocampus
GATTCGACGGTTCACG-1	Lateral_ventricle
GATTGACACTCTGCTC-1	Cortex_5
GATTGCTCCAGTTGCA-1	Hypothalamus_1
GCAAACCCTACATTAT-1	Cortex_2
GCAAACCTTGGCCATA-1	Cortex_2
GCAAAGGGCGTTAGCC-1	Hypothalamus_1
GCAAATATTACGCTTT-1	Thalamus_1
GCAACACACTAGAACT-1	Thalamus_2
GCAACAGCAGTATGCG-1	Cortex_5
GCAACCACCAGACCGG-1	Cortex_4
GCAACCACGGCCGCGT-1	Thalamus_2
GCAAGAATTCCTTGGC-1	Thalamus_1
GCAAGTGCACAGAGAA-1	Pyramidal_layer_dentate_gyrus
GCACAAACCCTAGATG-1	Hypothalamus_1
GCACAAGTGTCGGAAG-1	Cortex_1
GCACACACTGGTAGCC-1	Cortex_2
GCACGCCTACTTAGAT-1	Hypothalamus_1
GCACTAGTCGCGCTAT-1	Cortex_3
GCACTGCCTACCTTTA-1	Cortex_5
GCACTGTGCAAATGTA-1	Cortex_1
GCAGACCCAGCACGTA-1	Cortex_4
GCAGATCCATAAGACT-1	Cortex_2
GCAGATTAGGGATATC-1	Hypothalamus_2
GCAGCACACAGCCCAG-1	Thalamus_1
GCAGCGGTGGGCATTA-1	Cortex_1
GCAGGAACTTAGATCT-1	Thalamus_2
GCAGGACTATAGAATA-1	Thalamus_1
GCAGGTAGAGTATGGT-1	Cortex_4
GCAGTGTGGCTATAGG-1	Cortex_5
GCATAGAGCACTCAGG-1	Hypothalamus_2
GCATCCCTAACTTTGA-1	Pyramidal_layer
GCATGAGGGACGCGGC-1	Cortex_1
GCATTGTAATTCATAT-1	Thalamus_2
GCCACAATTTAAGGAC-1	Thalamus_1
GCCACTCAGAGCGCGA-1	Cortex_5
GCCAGGAAAGAACACT-1	Lateral_ventricle
GCCAGGAGTAACCGAT-1	Cortex_1
GCCAGGCGTTCGCATG-1	Cortex_5
GCCATATTGCACACAG-1	Cortex_1
GCCATCGAGCTGCGTG-1	Hypothalamus_2
GCCCACCAAGGCTGTC-1	Cortex_3
GCCCAGTTGGTATGCC-1	Hippocampus
GCCCGACTTCTTCCCG-1	Thalamus_1
GCCCGATCTGTGGTCG-1	Striatum
GCCCGCGCGTAAACGG-1	Hypothalamus_2
GCCCGCGCGTTTGACA-1	Hippocampus
GCCCGTAATACCTTCT-1	Fiber_tract
GCCCTAGCCGTCGCGA-1	Thalamus_2
GCCGAAATTCCTACGT-1	Thalamus_1
GCCGACCCACGACTGC-1	Hypothalamus_1
GCCGATTGGCCAAGCT-1	Hypothalamus_2
GCCGCATTAGTCCGGC-1	Thalamus_2
GCCGCTTGTGAGAAAC-1	Thalamus_1
GCCGGAAACACATCTT-1	Cortex_5
GCCGGGTTAGGGTCGC-1	Hypothalamus_2
GCCTAGCGATCTGACC-1	Hippocampus
GCCTATAGTGTCAGGG-1	Cortex_1
GCCTATTCCGATATAG-1	Hippocampus
GCCTATTTGCTACACA-1	Cortex_1
GCCTCATCTGGAAATA-1	Cortex_3
GCCTCTATACATAGCA-1	Cortex_2
GCCTTCAGCCCTACCG-1	Hippocampus
GCCTTGTATATGCAGT-1	Hippocampus
GCGAAACGATCGGGAG-1	Cortex_2
GCGAAACTTAACTGGA-1	Cortex_2
GCGAAGCCATACCCGT-1	Pyramidal_layer_dentate_gyrus
GCGACCCAACCATCTG-1	Hypothalamus_1
GCGACGATAGTTGTAC-1	Hypothalamus_2
GCGAGAGTTGCGTCCA-1	Lateral_ventricle
GCGAGGCCCGAGCAGA-1	Thalamus_1
GCGAGTTCTGCAAAGA-1	Hypothalamus_2
GCGATTCTGGAAGCAG-1	Cortex_4
GCGATTGTTAACGTTA-1	Fiber_tract
GCGCAAATATATTCAA-1	Hypothalamus_1
GCGCAAGAGCGCGCTG-1	Cortex_1
GCGCATCCAGTCAGCA-1	Cortex_1
GCGCCGTTCCACGATA-1	Fiber_tract
GCGCGATGGGTCAAGT-1	Cortex_5
GCGCGGTCTAGTAACT-1	Lateral_ventricle
GCGCGTCATTGGTACA-1	Cortex_5
GCGCTAATTGAATAGA-1	Fiber_tract
GCGCTATGCCGAGGCA-1	Thalamus_1
GCGCTGATCCAGACTC-1	Cortex_1
GCGCTGCTTTGCATTT-1	Cortex_1
GCGCTTAAATAATTGG-1	Cortex_5
GCGGACCGCGTTGTGG-1	Hypothalamus_2
GCGGAGAAACTTCGCA-1	Hypothalamus_2
GCGGAGAGGGAGAACG-1	Striatum
GCGGCAAAGTATTGCC-1	Hypothalamus_1
GCGGCTCTGACGTACC-1	Thalamus_1
GCGGGAACCAGGCCCT-1	Hippocampus
GCGGGCGAGCCTTACC-1	Fiber_tract
GCGGTAACCCAAATGA-1	Cortex_1
GCGGTCCCTAGACGCA-1	Cortex_3
GCGGTGAACTGCGCTC-1	Cortex_4
GCGGTTCCCTATCATG-1	Hypothalamus_2
GCGTAAATGGCCATAA-1	Cortex_4
GCGTCCCTAAGACATA-1	Hypothalamus_1
GCGTCGAAATGTCGGT-1	Cortex_3
GCGTCGCCAGGGTGAT-1	Striatum
GCGTCTCTGCATTGGG-1	Thalamus_1
GCGTGGTACTGGGTTA-1	Cortex_3
GCTAAACCTGAGGTGA-1	Hippocampus
GCTAACTGAAGTCTGA-1	Cortex_2
GCTAAGTAGTTTCTCT-1	Striatum
GCTAATACCGAATGCC-1	Hippocampus
GCTACGACTTATTGGG-1	Fiber_tract
GCTACTATAGTAGAGT-1	Cortex_2
GCTAGACCGTCTACTG-1	Cortex_4
GCTAGAGTAGAGATGT-1	Cortex_2
GCTAGCGATAGGTCTT-1	Hypothalamus_1
GCTAGCTTGAATAGCT-1	Hypothalamus_2
GCTAGGCACCACGGAG-1	Cortex_2
GCTAGTAGAGCTTGTA-1	Fiber_tract
GCTAGTTTCATTGAGG-1	Pyramidal_layer
GCTATACGTCTCGGAC-1	Cortex_3
GCTATCATACTCATGG-1	Cortex_2
GCTATCGCGGCGCAAC-1	Fiber_tract
GCTCAATCCGTTTATT-1	Hypothalamus_2
GCTCAATGTAATACCG-1	Striatum
GCTCATTACTGCATGT-1	Cortex_4
GCTCCTGACATACTGG-1	Hypothalamus_2
GCTCGCTCATGTCCAA-1	Cortex_1
GCTCGGAATTTAAAGC-1	Cortex_1
GCTCTAAACCCTGACG-1	Hippocampus
GCTCTATGTTACGTGC-1	Pyramidal_layer_dentate_gyrus
GCTCTCGGGTACCGAA-1	Hippocampus
GCTCTTTCCGCTAGTG-1	Striatum
GCTGAATCTTCCAATC-1	Hypothalamus_1
GCTGAGGCGTGAGTAT-1	Fiber_tract
GCTGCACGGTTTCTTA-1	Lateral_ventricle
GCTGCTAAGTAGTCGA-1	Striatum
GCTGCTACTGCGTAGC-1	Cortex_2
GCTGCTCTCCGGACAC-1	Pyramidal_layer_dentate_gyrus
GCTGGCATATTCACCT-1	Thalamus_1
GCTGGCGGCGCATGCT-1	Striatum
GCTGGTTTAGGCCATA-1	Thalamus_2
GCTGTATTACTGGCCC-1	Thalamus_1
GCTGTTGCTACCGAAC-1	Cortex_3
GCTTAATGTAACTAAC-1	Striatum
GCTTATGAAGCAGGAA-1	Cortex_3
GCTTCCGTCCCTAGAC-1	Lateral_ventricle
GCTTCGACGTTCAATC-1	Hypothalamus_1
GCTTGATGATAATCAG-1	Hippocampus
GCTTGGATCGATTAGG-1	Cortex_1
GCTTTCAGAGGAGGTG-1	Cortex_1
GGAAAGTGCCCATGCC-1	Cortex_1
GGAACCGTGTAAATTG-1	Hypothalamus_2
GGAACCTTGACTCTGC-1	Hypothalamus_1
GGAAGCTCGCTTACAG-1	Cortex_4
GGAATAACCTCAAGAA-1	Cortex_4
GGAATGCGCTAGCGTG-1	Fiber_tract
GGACCAACAGGATAAC-1	Striatum
GGACCTCTAGGCCGCC-1	Hypothalamus_1
GGACTCGTGAGTGGTC-1	Hypothalamus_1
GGAGAAGTCATTGGCA-1	Pyramidal_layer_dentate_gyrus
GGAGACGACACCTTTG-1	Fiber_tract
GGAGCACCAAGAACTA-1	Cortex_3
GGAGCGAGGCCTACTT-1	Lateral_ventricle
GGAGGATTGAAAGGAG-1	Cortex_4
GGAGGGCTTGGTTGGC-1	Striatum
GGAGTGCCGCCCTGGA-1	Hippocampus
GGATACTCATGAATTG-1	Cortex_1
GGATCAAAGGACGAGG-1	Cortex_4
GGATCCGGAATATACT-1	Striatum
GGATCTTACTGCCCTT-1	Hypothalamus_1
GGATCTTGACTCAACC-1	Thalamus_2
GGATGAAGATCGCTGA-1	Cortex_3
GGATGACGCGAGTTTA-1	Thalamus_1
GGATGCTGGCGTTCCT-1	Thalamus_2
GGATGTCCTTACCGCA-1	Cortex_3
GGATTCAGTACGGTGG-1	Pyramidal_layer
GGATTCCGCTATACCC-1	Cortex_1
GGATTGCTGTGACTCC-1	Cortex_5
GGATTTCACTTCTATA-1	Cortex_3
GGCAAAGGCGCCAATA-1	Hypothalamus_2
GGCAAATTACTTTACT-1	Thalamus_1
GGCAAGCCCATAGTGG-1	Lateral_ventricle
GGCAAGGCGAAATAGC-1	Lateral_ventricle
GGCAATAGTCAATGAG-1	Pyramidal_layer_dentate_gyrus
GGCACTCCACTGGGCA-1	Thalamus_1
GGCAGCAAACCTATGC-1	Cortex_5
GGCATACAGGTAGCGG-1	Thalamus_1
GGCATATCGGTTCTGC-1	Cortex_1
GGCATCAACGAGCACG-1	Cortex_4
GGCCACAAGCGATGGC-1	Cortex_4
GGCCCTCACCCACTTA-1	Fiber_tract
GGCCGAGACTCTGGTG-1	Hypothalamus_1
GGCCGGCGTCTGCTAT-1	Cortex_5
GGCCGTTTGGGTTTCA-1	Hypothalamus_1
GGCGAAATCTAACTTG-1	Cortex_3
GGCGCAGGACATCTTC-1	Thalamus_2
GGCGCATGAATTGATG-1	Thalamus_1
GGCGCGGAGATCTTTC-1	Cortex_5
GGCGCGTTCGAGTTTA-1	Fiber_tract
GGCGCTCCTCATCAAT-1	Cortex_1
GGCGGAGTAATATTAG-1	Thalamus_1
GGCGGTAGGATCATTG-1	Pyramidal_layer_dentate_gyrus
GGCGTCCTATCCGCTG-1	Thalamus_1
GGCTAAAGGGCGGGTC-1	Cortex_5
GGCTACTATACACTCC-1	Lateral_ventricle
GGCTATTAAGTTGTAT-1	Thalamus_1
GGCTCCTCCACCTGTT-1	Hypothalamus_1
GGCTCGCGTTGAGGTA-1	Cortex_1
GGCTCGTGCCACCAGC-1	Hippocampus
GGCTCTGCTCCAACGC-1	Hippocampus
GGCTGAAATAGCAAAG-1	Cortex_2
GGCTGGCTAGCTTAAA-1	Cortex_3
GGCTTTCAATAAGGGT-1	Striatum
GGGAACGGGAGGTTAG-1	Thalamus_1
GGGAACGGTTTCAGAT-1	Hypothalamus_1
GGGAAGACGGTCTGTC-1	Cortex_2
GGGACAGAGTTACTCC-1	Thalamus_2
GGGACCCGTATATCTT-1	Lateral_ventricle
GGGACTGCATAGATAG-1	Hypothalamus_2
GGGAGAACTCACAGTA-1	Hippocampus
GGGAGGATGCCCGAAA-1	Thalamus_1
GGGAGTAATGGCTGGC-1	Cortex_1
GGGAGTTAATGAGGCG-1	Fiber_tract
GGGATGGTCGTAACCG-1	Fiber_tract
GGGATTTACCGCACCT-1	Cortex_3
GGGCAACCGCACGTGC-1	Thalamus_2
GGGCAGAGCAATCGTT-1	Striatum
GGGCCCGTCTTAAACA-1	Thalamus_1
GGGCCCTACGAAAGGG-1	Thalamus_2
GGGCCGGCCGAAGTAC-1	Striatum
GGGCGATATGTGTGAA-1	Pyramidal_layer_dentate_gyrus
GGGCGGCAAATGAATT-1	Hypothalamus_2
GGGCGGGTTCCCTACG-1	Thalamus_1
GGGCGGTCCTATTGTC-1	Fiber_tract
GGGCGTACATTTATAT-1	Hippocampus
GGGCGTCACCACGTAA-1	Hypothalamus_2
GGGCGTCCACTGGCTC-1	Cortex_1
GGGCGTGGTTTCCCAG-1	Cortex_2
GGGCGTTTACATTCAT-1	Hypothalamus_1
GGGCTATGATCGATGG-1	Fiber_tract
GGGCTCATCGAACCCA-1	Cortex_1
GGGCTGCCTAGGGCGA-1	Hippocampus
GGGCTGGTTAGTCGCG-1	Thalamus_1
GGGTACCCACGGTCCT-1	Cortex_3
GGGTACTTCATGAACT-1	Thalamus_1
GGGTATGTATGCACTT-1	Lateral_ventricle
GGGTATTCTAGCAAAC-1	Hypothalamus_1
GGGTCACCGTGACGGT-1	Thalamus_1
GGGTCAGGAGCTAGAT-1	Striatum
GGGTCCTTGGAAGAAG-1	Hypothalamus_1
GGGTGACACCTTAACT-1	Fiber_tract
GGGTGGTCCAGCCTGT-1	Cortex_4
GGGTGTTTCAGCTATG-1	Cortex_3
GGGTTAACATTTGAGT-1	Fiber_tract
GGGTTCAGACGAACAA-1	Fiber_tract
GGTAAATGTGCGTTAC-1	Cortex_4
GGTAACCGGGAGGATA-1	Thalamus_2
GGTAACTATGTATCTG-1	Cortex_3
GGTACAAACATGCTAT-1	Thalamus_1
GGTACATCTGGGACGA-1	Thalamus_2
GGTACCATTAAGACGG-1	Cortex_5
GGTAGAAGACCGCCTG-1	Cortex_2
GGTAGACCGTTGGGCG-1	Fiber_tract
GGTAGTGCTCGCACCA-1	Fiber_tract
GGTATTGCCGAGTTTA-1	Thalamus_1
GGTCACGTTAGATTCA-1	Cortex_1
GGTCAGTGGGTCCCAC-1	Fiber_tract
GGTCGGATAAACGGCG-1	Cortex_4
GGTCGGCCAGGAGCTT-1	Cortex_3
GGTCGGTAATTAGACA-1	Cortex_3
GGTCGGTCGTCCACAG-1	Fiber_tract
GGTCGTAAGCTCGCAC-1	Thalamus_2
GGTCTCTGAATGGACT-1	Hypothalamus_2
GGTCTGAGAATCTGGA-1	Fiber_tract
GGTCTTGAGCGCTCTT-1	Cortex_2
GGTGAAACCGGGAATG-1	Cortex_4
GGTGAACGGGCTAGCC-1	Cortex_1
GGTGAAGTACAGGGAT-1	Thalamus_1
GGTGAGATGCAGATAA-1	Pyramidal_layer
GGTGATAAGGAGCAGT-1	Striatum
GGTGATTTCATCTTGT-1	Cortex_1
GGTGCGGATAAGTGGC-1	Pyramidal_layer
GGTGCTGATCACAAAG-1	Lateral_ventricle
GGTGCTGGTACACATT-1	Thalamus_1
GGTGGACTGCTCTGGC-1	Cortex_5
GGTTACCACCCTCGGG-1	Thalamus_1
GGTTAGCTATATGTCT-1	Cortex_2
GGTTAGGCTTGGAGAA-1	Hypothalamus_2
GGTTAGTTACGGCGCC-1	Lateral_ventricle
GGTTCTACTCGTCTGA-1	Cortex_5
GGTTTAATTACCATCG-1	Hypothalamus_1
GGTTTACAATCTCAAT-1	Lateral_ventricle
GGTTTAGCCTTTCTTG-1	Cortex_2
GGTTTCAATCGGTCAG-1	Cortex_3
GGTTTGAGTGCTGGAA-1	Cortex_3
GTAACTTGCGGCAGTC-1	Cortex_1
GTAAGCGGGCAGTCAG-1	Hippocampus
GTAAGGATTTGTCGGA-1	Cortex_1
GTAAGTAACAGTCTGG-1	Striatum
GTAAGTAGGGTATACC-1	Pyramidal_layer_dentate_gyrus
GTAATAAAGGGCTCCC-1	Cortex_4
GTAATCTGATTCTTCG-1	Hypothalamus_2
GTACACTTACCTGAAG-1	Hypothalamus_2
GTACAGAGGCAAGGGT-1	Striatum
GTACGACGGCGCTGCG-1	Cortex_3
GTACGAGATTGCGACA-1	Hippocampus
GTACGCTTCATTGCAC-1	Striatum
GTACGTTTGCCCGTCA-1	Fiber_tract
GTACTAAGATTTGGAG-1	Pyramidal_layer_dentate_gyrus
GTACTCCCTTATCGCT-1	Thalamus_2
GTACTCCTGGGTATGC-1	Cortex_5
GTACTGAGGTCGTAAC-1	Cortex_3
GTACTGCATGAAGCGT-1	Cortex_3
GTACTGGAGTTAGACC-1	Striatum
GTACTTGGGCACTTCT-1	Hippocampus
GTAGACAACCGATGAA-1	Cortex_1
GTAGACACGCCTGACT-1	Cortex_2
GTAGACGTCGTTACAT-1	Cortex_3
GTAGAGGGAGACAAGT-1	Hypothalamus_2
GTAGCCAAACATGGGA-1	Striatum
GTAGCGCTGTTGTAGT-1	Cortex_4
GTAGCGGCTATACACT-1	Fiber_tract
GTAGCTCCGGGAGGCT-1	Hypothalamus_1
GTAGCTTCCTCTTGTT-1	Cortex_3
GTAGGTGATCCGTGTA-1	Cortex_1
GTAGTCGCGGGAATCA-1	Cortex_2
GTAGTCTACGATATTG-1	Cortex_2
GTAGTTCGAAGGCGAA-1	Hypothalamus_1
GTATAGGACTCAGTAG-1	Pyramidal_layer
GTATATGTTACGGCGG-1	Cortex_1
GTATCAAACGTTAGCT-1	Cortex_2
GTATCAGCTTGGGTTC-1	Hippocampus
GTATCTCAGTCTTGAC-1	Thalamus_2
GTATCTTTCATAACCA-1	Fiber_tract
GTATGAAATTTCACTC-1	Thalamus_2
GTATGACGTGGGAAAC-1	Cortex_1
GTATGTGGGTCTAGTT-1	Cortex_3
GTATTAAGGCGTCTAA-1	Fiber_tract
GTATTCTGAGAAACGA-1	Thalamus_1
GTATTCTTACCGTGCT-1	Cortex_1
GTCAAAGAAGTGGTGT-1	Thalamus_2
GTCAAAGTTTACATAG-1	Fiber_tract
GTCAAGCGGACTCGGG-1	Striatum
GTCAATTGTACTGAAG-1	Cortex_4
GTCACAAAGTTTCCAA-1	Cortex_1
GTCACTCTCCAAATCT-1	Hippocampus
GTCAGAATAGTCTATG-1	Thalamus_2
GTCAGTTGTGCTCGTT-1	Cortex_4
GTCATGCACCTCCGTT-1	Hippocampus
GTCATGGACATGACTA-1	Hippocampus
GTCATTAGAGCGAACG-1	Fiber_tract
GTCCAATATTTAGCCT-1	Striatum
GTCCATTACTGCTACG-1	Cortex_5
GTCCCAACGTAAAGTA-1	Fiber_tract
GTCCCGCGACGTTATG-1	Cortex_5
GTCCGGACCTGAAATT-1	Cortex_2
GTCCGGCTGAATTGCG-1	Pyramidal_layer_dentate_gyrus
GTCCTACAGGCGGCTC-1	Fiber_tract
GTCCTACGAATAGTCT-1	Cortex_2
GTCCTTCTAGTGGGTT-1	Cortex_4
GTCGAATTTGGGCGCT-1	Hypothalamus_1
GTCGCCGTTGTGTGTT-1	Hypothalamus_1
GTCGCGTAACCCGTTG-1	Lateral_ventricle
GTCGGATATCTCAGAC-1	Thalamus_1
GTCGGATGTAGCGCGC-1	Cortex_1
GTCGGGAAGCAGAAAC-1	Cortex_2
GTCGTACCATCTCGGG-1	Fiber_tract
GTCGTATTGGCGTACA-1	Cortex_4
GTCGTCAATTATAAGG-1	Cortex_1
GTCGTTATTCGCTTAT-1	Striatum
GTCTATCTGAGTTTCT-1	Thalamus_1
GTCTATTGGTTCCGGT-1	Cortex_3
GTCTCAAGGCCCGGCT-1	Cortex_2
GTCTCGATCTGCTTTC-1	Cortex_3
GTCTGGGCGGTCGAGA-1	Thalamus_1
GTCTTAGTACAGCCGG-1	Cortex_1
GTGAAACGGCGCCACC-1	Cortex_1
GTGAAACGTGCTCCAC-1	Cortex_3
GTGAACTCCCATTCGA-1	Cortex_5
GTGACAGCTTCCCACT-1	Cortex_2
GTGACCGCACACTACG-1	Cortex_3
GTGACGCAGGTTTCAT-1	Cortex_2
GTGACTTCAGTAGTGC-1	Hypothalamus_2
GTGAGCGTGCTGCACT-1	Thalamus_2
GTGAGGACACTTAAGG-1	Striatum
GTGAGGAGCGGTTGAG-1	Cortex_4
GTGAGTGGTACAACGC-1	Fiber_tract
GTGATCAAGCGTGCAC-1	Hypothalamus_1
GTGATCACTAACGCCT-1	Cortex_3
GTGATCATAGATCTGC-1	Hypothalamus_2
GTGATCCTTGTCATGA-1	Cortex_2
GTGATTCGCCGCTCAA-1	Thalamus_1
GTGCAACAAATGTGGC-1	Cortex_3
GTGCACCAGCTTCAAC-1	Striatum
GTGCACGAAAGTGACT-1	Cortex_3
GTGCCATCACACGGTG-1	Thalamus_1
GTGCCCGTTCGGATTC-1	Striatum
GTGCCGCTTCAAAGGT-1	Thalamus_1
GTGCCTCAGTGTACGG-1	Cortex_4
GTGCGAAATCGAACAC-1	Thalamus_1
GTGCGACAGGGAGTGT-1	Cortex_4
GTGCGCAGCTTGCTCC-1	Cortex_4
GTGCGGGACCATCGGC-1	Cortex_4
GTGCGGGTCTCCAAAT-1	Hippocampus
GTGCGTGTATATGAGC-1	Striatum
GTGCTCAAGTACTGTC-1	Thalamus_1
GTGGAACCTACATGCG-1	Cortex_1
GTGGACCAACCCGATT-1	Thalamus_2
GTGGACGCATTTGTCC-1	Striatum
GTGGACGTGCTGAGAC-1	Pyramidal_layer
GTGGAGCGTTTACCGA-1	Thalamus_2
GTGGAGTCGGCGGTTG-1	Hypothalamus_2
GTGGCAAACAGCGGCA-1	Thalamus_2
GTGGCGGTCCCAGCGT-1	Thalamus_2
GTGGGAAGACTGAATC-1	Thalamus_2
GTGGGCTTAGACACAC-1	Thalamus_1
GTGGTATAGTCTGCCG-1	Hypothalamus_1
GTGGTGGCCAAGTGAA-1	Striatum
GTGGTTACTTCTTTCG-1	Cortex_5
GTGGTTTCCGCCTTTC-1	Thalamus_1
GTGTACCTTGGCTACG-1	Fiber_tract
GTGTATATCAGCGGGC-1	Cortex_2
GTGTATGACTTTAAAG-1	Cortex_4
GTGTCGTATAGCGTTC-1	Cortex_2
GTGTGAATAACTTAGG-1	Cortex_3
GTGTTACTATGCGTCC-1	Striatum
GTTAAAGTAGGACTGG-1	Cortex_2
GTTAACATCACTTAAA-1	Cortex_2
GTTAAGGGTGCGATGT-1	Cortex_2
GTTACAATTGGTGACG-1	Thalamus_1
GTTACCTACAACTTGC-1	Lateral_ventricle
GTTACGGCCCGACTGC-1	Cortex_5
GTTACTTTGGGCCTAG-1	Thalamus_1
GTTAGAGTGTGCCGCT-1	Cortex_4
GTTATATTATCTCCCT-1	Fiber_tract
GTTATCACCTTCTGAA-1	Cortex_4
GTTATTAACGTGGGAG-1	Fiber_tract
GTTCACAGGAGTCTAG-1	Thalamus_1
GTTCATCGTTTGGCTG-1	Cortex_5
GTTCCAGTCTGACCAT-1	Hippocampus
GTTCGACAATTGTATA-1	Hypothalamus_1
GTTCGCCATAAGTGCC-1	Thalamus_1
GTTCGTCTAAAGAACT-1	Cortex_3
GTTCTTCCCTCGATGT-1	Fiber_tract
GTTGAACCGGTTCCAT-1	Thalamus_1
GTTGAGTCCCGCCGGT-1	Cortex_2
GTTGCACGGAGTTTCG-1	Pyramidal_layer_dentate_gyrus
GTTGGATTCAGTGGCT-1	Cortex_5
GTTGGATTGAGAACAC-1	Cortex_3
GTTGGATTTGCGTTGG-1	Thalamus_1
GTTGGTCATGCTATCC-1	Striatum
GTTGTCGTGTTAGTTG-1	Hippocampus
GTTTACGTTCCATCTG-1	Fiber_tract
GTTTCATATCGTCGCT-1	Thalamus_2
GTTTCCTGGAGGGTGA-1	Pyramidal_layer_dentate_gyrus
GTTTCTGCAGTCTCCC-1	Lateral_ventricle
GTTTGACCAAATCCTA-1	Pyramidal_layer_dentate_gyrus
GTTTGGCCCAAGTTAT-1	Striatum
GTTTGGCCGCTCAGCG-1	Cortex_3
GTTTGGGCTTGTGAGC-1	Striatum
GTTTGGTAGGGTCAAC-1	Striatum
GTTTGGTGATCGGTGC-1	Hypothalamus_1
TAAACCCAGGAGGGCA-1	Hypothalamus_2
TAAAGAGCCCGAAACC-1	Cortex_1
TAAAGCGGTATTTCCA-1	Lateral_ventricle
TAAAGCGTTAGGAGAA-1	Cortex_1
TAAAGCTGCAATAGGG-1	Cortex_5
TAAATGAATCCGTTTC-1	Hippocampus
TAACAAAGGGAGAAGC-1	Hippocampus
TAACAGCGTTTGTGCT-1	Hypothalamus_1
TAACATACAATGTGGG-1	Fiber_tract
TAACATACACGCGATC-1	Hypothalamus_2
TAACCGCCCGCAGTGC-1	Cortex_1
TAACCTACCGTCCGAG-1	Cortex_4
TAACGCTTTGAGAGCG-1	Lateral_ventricle
TAACTATCGAAGGTCC-1	Hippocampus
TAACTCATCCGCGCGG-1	Thalamus_1
TAACTCCATGGAGGCT-1	Fiber_tract
TAAGAGGGACAGGGAC-1	Hypothalamus_1
TAAGATTTAGCGGGAG-1	Cortex_4
TAAGCAGGCGACACGC-1	Thalamus_2
TAAGCGCGAATCAAAT-1	Hypothalamus_1
TAAGGAACTTGTGGGA-1	Pyramidal_layer
TAAGGCAACATAAGAT-1	Hippocampus
TAAGGCATAACATCAA-1	Fiber_tract
TAAGGCCCGTCACCCT-1	Cortex_2
TAAGGCTGAATCCCTC-1	Cortex_3
TAAGGGCCTGTCCGAT-1	Cortex_2
TAAGGGCTGGGAGAGG-1	Thalamus_2
TAAGTAACATCTTGAC-1	Thalamus_1
TAAGTCGCCGAGTATC-1	Hypothalamus_2
TAAGTTGCGACGTAGG-1	Cortex_2
TAATAAACAAGGAGAT-1	Cortex_4
TAATACACAGTAGTAT-1	Hippocampus
TAATAGAACAGAGTTA-1	Hypothalamus_2
TAATAGGTCACCAGAA-1	Hypothalamus_1
TAATAGTGACGACCAG-1	Cortex_3
TAATATTGAAATTCGC-1	Pyramidal_layer
TAATCGATCCGTACGT-1	Cortex_1
TAATGAAAGACCCTTG-1	Lateral_ventricle
TAATTAGATGGATATG-1	Cortex_1
TACAACGCACAACTCA-1	Thalamus_1
TACAAGTCTCGTGCAT-1	Thalamus_2
TACAGAAACGGTGGGC-1	Cortex_5
TACATAGGCATACACC-1	Hypothalamus_2
TACATTTCTAACGTGC-1	Thalamus_1
TACCAAATAGCCCAGA-1	Striatum
TACCAATAAAGTACCA-1	Cortex_2
TACCAGAAGTAGGTTC-1	Hypothalamus_2
TACCAGCTAGGTTTAA-1	Cortex_1
TACCAGGAATCCCGTC-1	Hypothalamus_1
TACCGCGGACTTGCAG-1	Cortex_1
TACCGGCTCACTGCCC-1	Lateral_ventricle
TACCGGTCGTTTCCAT-1	Thalamus_1
TACCGTAGGTTAACTA-1	Striatum
TACCGTGCCTCGGACC-1	Striatum
TACCTACTCCCAGTAT-1	Striatum
TACCTCACGCTTGTAC-1	Fiber_tract
TACCTCAGTTGTCTGT-1	Lateral_ventricle
TACCTCCACACCAATG-1	Hypothalamus_1
TACCTGCTGCACTGTG-1	Lateral_ventricle
TACCTTAAGATTTCCC-1	Thalamus_1
TACGAACACGACTTCA-1	Thalamus_1
TACGACGCTTGCTGCG-1	Hypothalamus_2
TACGACTGCCTCTTAG-1	Fiber_tract
TACGAGAACTTCACGT-1	Thalamus_1
TACGATGTTGATCATC-1	Thalamus_1
TACGCAGTTCTTTCCT-1	Thalamus_1
TACGCCATATTCTAAT-1	Hypothalamus_2
TACGCCGAGGGTACCC-1	Hypothalamus_1
TACGCCTCCATTCCGA-1	Striatum
TACGCTATAGAAACCT-1	Cortex_5
TACGCTGATAGTTGTA-1	Hypothalamus_1
TACGCTGCTGTGTTAA-1	Hypothalamus_1
TACGGGATGCTAGCAG-1	Cortex_1
TACGTACTAGTGCTGA-1	Hypothalamus_1
TACGTGCACTATGCTG-1	Hippocampus
TACGTTTACCGGCAAT-1	Thalamus_1
TACTATGGTTCCTCAG-1	Fiber_tract
TACTCCTCTAGTTGAC-1	Hypothalamus_1
TACTCGGCACGCCGGG-1	Thalamus_2
TACTCTCCGAACAAAT-1	Cortex_1
TACTCTTTCGTCTTCA-1	Fiber_tract
TACTGAACAGATTTAG-1	Hypothalamus_2
TACTGCAATCAATTAC-1	Cortex_5
TACTGGACAGCTCGGC-1	Thalamus_2
TACTTGTTAGTAGTCC-1	Cortex_3
TACTTTACTGAGCCGG-1	Cortex_1
TACTTTCCGCACGCCA-1	Thalamus_2
TAGAAAGGTGGCGCTA-1	Fiber_tract
TAGAATTAAGGGCAAC-1	Cortex_4
TAGACGAAACGCCAAT-1	Cortex_2
TAGACGCCCGTACCGG-1	Cortex_3
TAGACTACCTAGCGTT-1	Cortex_5
TAGAGATCATGCAACT-1	Thalamus_2
TAGAGCTACGAAGAAC-1	Cortex_3
TAGAGGTTCTACTTGT-1	Cortex_2
TAGAGTCTAAGCGAAC-1	Hypothalamus_2
TAGATATGGACTGGAA-1	Hypothalamus_2
TAGATCCGAAGTCGCA-1	Cortex_4
TAGATTCAAAGTGCGG-1	Hypothalamus_1
TAGATTCCTGGTTATT-1	Thalamus_2
TAGCAACCTGTCACAA-1	Hippocampus
TAGCCATTTCAAAGTC-1	Cortex_3
TAGCCGGCGGTCAGCG-1	Cortex_3
TAGCGTCCGGTGTGGT-1	Cortex_2
TAGCGTTGGGTCTTAC-1	Fiber_tract
TAGCTAAGTCCGGGAG-1	Pyramidal_layer_dentate_gyrus
TAGCTAGAAGGCATGA-1	Fiber_tract
TAGCTAGTGATGATGG-1	Fiber_tract
TAGCTCGCCTGATAAC-1	Fiber_tract
TAGGCATGTTACGCCA-1	Cortex_1
TAGGGAGCTTGGGATG-1	Cortex_1
TAGGGTGTTTCAAGAG-1	Hippocampus
TAGGTCCAAGTAAGGA-1	Lateral_ventricle
TAGGTCGCCGGAACTG-1	Cortex_4
TAGGTGACGATAACCT-1	Cortex_2
TAGGTGAGCCCTACTC-1	Thalamus_2
TAGGTGCTCGCCTAGC-1	Cortex_3
TAGGTGTTCCACAGAT-1	Striatum
TAGGTTCGAGTTCGTC-1	Fiber_tract
TAGTACCTTAGTGGTC-1	Fiber_tract
TAGTAGCTTATACCAG-1	Hypothalamus_1
TAGTCCGCAGAGAATG-1	Thalamus_1
TAGTCCTGCACTAAGC-1	Hypothalamus_1
TAGTCGATCACGGGTT-1	Cortex_3
TAGTCTAACAACGAGA-1	Thalamus_1
TAGTGAGAAGTGGTTG-1	Cortex_5
TAGTGCCCTCCAGAGT-1	Thalamus_1
TAGTGTCAGAAACGGC-1	Fiber_tract
TAGTTAAGATAGGATA-1	Cortex_4
TAGTTTATTCTTGCTT-1	Cortex_3
TATAAATCCACAAGCT-1	Hippocampus
TATAAGTGAGGATAGC-1	Hippocampus
TATACACAGACGCCTT-1	Fiber_tract
TATACACGCAAAGTAT-1	Hippocampus
TATACGCGTCATCACT-1	Cortex_2
TATACTCATGCGGCAA-1	Fiber_tract
TATAGAGTCGCTTGAA-1	Lateral_ventricle
TATAGATGGTCGCAGT-1	Cortex_4
TATAGGGTACTCATGA-1	Thalamus_2
TATAGTTAGGTGTACT-1	Hypothalamus_1
TATATAGGGCTTTACG-1	Hypothalamus_1
TATATATCGAGAAATG-1	Hypothalamus_1
TATATCCCTGGGAGGA-1	Cortex_1
TATATTCGCGTCGATA-1	Cortex_1
TATCACAGCACGGGCA-1	Cortex_5
TATCACCCAACCGACC-1	Cortex_4
TATCCAATTGGTTATC-1	Cortex_2
TATCCATATCATGCGA-1	Pyramidal_layer
TATCCATCTCGGTTAG-1	Hypothalamus_1
TATCCGCACCGTCGGG-1	Striatum
TATCCTGCATGGGAAT-1	Cortex_3
TATCGATCTATGCATA-1	Cortex_1
TATCGATGATTAAACG-1	Hippocampus
TATCTACAGAGGTAAT-1	Thalamus_2
TATCTACCACAGCGGG-1	Hypothalamus_2
TATCTTGCAATACAAC-1	Thalamus_2
TATGAAGACAGGTGCG-1	Thalamus_2
TATGATCTTCTCTTTA-1	Cortex_2
TATGATTCTGCTTGGT-1	Cortex_4
TATGCTCCCTACTTAC-1	Cortex_5
TATGGAGTTTCTCGTT-1	Cortex_1
TATGGATGTGCTACGC-1	Pyramidal_layer_dentate_gyrus
TATGGCCCGGCCTCGC-1	Thalamus_2
TATGGGACCGAGCAGG-1	Thalamus_1
TATGGGTACGTATCGT-1	Thalamus_1
TATGGTCTGAGTAACA-1	Thalamus_2
TATGGTTAGTGGGAGA-1	Cortex_5
TATGTCAAGACCGACT-1	Cortex_1
TATGTCTCATTGTGCC-1	Cortex_3
TATTAACCTGACCGCG-1	Fiber_tract
TATTACCATCCTGCTT-1	Cortex_1
TATTATGTTTGCCTGC-1	Thalamus_2
TATTCAATTCTAATCC-1	Fiber_tract
TATTCCACTCAGCTCG-1	Fiber_tract
TATTCCGAGCTGTTAT-1	Cortex_5
TATTCCGGCAGTCCTA-1	Cortex_4
TATTCCTCCGCCCACT-1	Thalamus_1
TATTCGTGCCAGAATA-1	Hypothalamus_2
TATTTAGTCTAGATCG-1	Hippocampus
TATTTATACCGAGTAG-1	Cortex_1
TATTTGTTACCCTTTA-1	Pyramidal_layer_dentate_gyrus
TCAAACAACCGCGTCG-1	Hippocampus
TCAAACTTAGATTGTT-1	Pyramidal_layer_dentate_gyrus
TCAAAGTCACGGCGTC-1	Hypothalamus_1
TCAAATTTGAGACTCA-1	Cortex_2
TCAACAAAGATAATTC-1	Thalamus_1
TCAACACATTGGGTAA-1	Cortex_3
TCAACATAGCGCCCTA-1	Fiber_tract
TCAACATCGACCGAGA-1	Thalamus_2
TCAACCATGTTCGGGC-1	Pyramidal_layer_dentate_gyrus
TCAACGAGGAGACAAA-1	Hypothalamus_2
TCAACGCAGGAAATAA-1	Thalamus_1
TCAACGCGACCGGCAG-1	Fiber_tract
TCAACTAACGTATAAC-1	Thalamus_2
TCAAGGTTACTACACC-1	Cortex_2
TCAATACGCCGTCATG-1	Striatum
TCACAGCAAACTCGAA-1	Hypothalamus_2
TCACAGGAGAATAAGA-1	Fiber_tract
TCACAGGGAATCGCAA-1	Cortex_2
TCACAGGTTATTGGGC-1	Thalamus_1
TCACATCTTATCTGAT-1	Thalamus_2
TCACCCTCTTAAGATT-1	Fiber_tract
TCACCGCTCGGCACTC-1	Cortex_1
TCACGATGTCCGTGGA-1	Thalamus_1
TCACGCATTGTAGATC-1	Thalamus_1
TCACGGCCCAAGAGAG-1	Hypothalamus_1
TCACGGTCATCGCACA-1	Pyramidal_layer_dentate_gyrus
TCACGTGCCCGATTCA-1	Hypothalamus_2
TCACTCGTGCAACGGC-1	Cortex_4
TCAGACGCTATAGAAG-1	Striatum
TCAGCAAATGCATCTC-1	Hippocampus
TCAGCAGTAGGCCCTG-1	Hypothalamus_1
TCAGGGTGTAACGTAA-1	Hippocampus
TCAGGTTCTTTGAGAA-1	Thalamus_1
TCAGTACTGACCCGCG-1	Pyramidal_layer_dentate_gyrus
TCAGTAGGGACTATAA-1	Fiber_tract
TCAGTGTATACGTCAT-1	Hypothalamus_1
TCATACTTACAGATCC-1	Hippocampus
TCATATGAGCTTTGTT-1	Cortex_2
TCATCACTCGAGCTCG-1	Fiber_tract
TCATCCCAGAGGGTGG-1	Cortex_1
TCATCGATGGTCCCAA-1	Hypothalamus_2
TCATGCAGGTTCTCAT-1	Cortex_1
TCATTTAAGTCTCCGA-1	Cortex_1
TCCAACTTTAAATTCT-1	Thalamus_1
TCCAATAAAGGCTACC-1	Striatum
TCCACAATGGTTTACG-1	Thalamus_1
TCCACCTCTAGCCTTT-1	Striatum
TCCACTTTATCTAGGT-1	Striatum
TCCAGAGCACCGGTTC-1	Lateral_ventricle
TCCAGGCGAGTACGGT-1	Thalamus_1
TCCAGGGTATATACGA-1	Cortex_2
TCCATCAATACTAATC-1	Hypothalamus_1
TCCATTAGTTGGATAG-1	Cortex_1
TCCATTGTGACCTCGT-1	Cortex_4
TCCCAAAGACGAAGGA-1	Hippocampus
TCCCAGCTTTAGTCTG-1	Thalamus_1
TCCCAGGCTTAGCTAA-1	Thalamus_1
TCCCGCGTACTCCTGG-1	Pyramidal_layer_dentate_gyrus
TCCCGGGTGTGCTGCT-1	Thalamus_1
TCCCGGTCAGGAATTT-1	Cortex_1
TCCCGTCAGTCCCGCA-1	Cortex_3
TCCCGTGTGCAATTTG-1	Striatum
TCCCTGGCGTATTAAC-1	Thalamus_2
TCCCTGGCTCGCTGGA-1	Thalamus_2
TCCCTTAGATTACTCG-1	Cortex_1
TCCGAACTTGGCTTAC-1	Thalamus_2
TCCGACCGCTAATCAA-1	Hypothalamus_1
TCCGAGAAGGCTAAGC-1	Cortex_4
TCCGATAATTGCCATA-1	Fiber_tract
TCCGATGACTGAGCTC-1	Cortex_3
TCCGATGGTGCGACAT-1	Pyramidal_layer_dentate_gyrus
TCCGATTACATTGCCG-1	Thalamus_1
TCCGCCTGTCTACAAG-1	Cortex_2
TCCGCGGCAGCATCTG-1	Cortex_3
TCCGCGGCCCAATGAA-1	Cortex_2
TCCGCTGTCATCCCGG-1	Cortex_2
TCCGCTTATCCCATTA-1	Striatum
TCCGGCCTAGCGTACA-1	Cortex_1
TCCGGTTCGTCCGGTC-1	Fiber_tract
TCCGTTAAGCTAATAT-1	Cortex_2
TCCGTTTAGCCTTGAA-1	Cortex_3
TCCTAAATTGGGAAGC-1	Cortex_2
TCCTAACCGTCGGGCA-1	Lateral_ventricle
TCCTACATCCACGGCC-1	Cortex_2
TCCTAGCAAAGAAGCT-1	Thalamus_1
TCCTCCTAAGACATTC-1	Thalamus_2
TCCTCGGGCTGGGCTT-1	Striatum
TCCTCTACGAGATGGC-1	Hippocampus
TCCTCTCCAGTTGTCC-1	Thalamus_2
TCCTCTGGCCCATTAG-1	Cortex_5
TCCTGCCAACTGGAGA-1	Cortex_4
TCCTGCGTTGATACTC-1	Thalamus_2
TCCTTACGACGGTCCG-1	Cortex_2
TCCTTCAGTGGTCGAA-1	Cortex_3
TCCTTTAAATCCGCTT-1	Cortex_2
TCCTTTCTTACGCTTA-1	Pyramidal_layer_dentate_gyrus
TCGAAATTTAGGACCA-1	Thalamus_1
TCGAAGAACCGAGCAC-1	Cortex_2
TCGAATATCCCGCAGG-1	Hypothalamus_1
TCGACAACTGAACCCG-1	Thalamus_2
TCGACATAGCGTAGCG-1	Hypothalamus_1
TCGAGACCAACACCGT-1	Fiber_tract
TCGAGCCAGGCAGGCC-1	Hypothalamus_1
TCGATAGGCTAGTCGC-1	Cortex_1
TCGCAAAGATGCATTT-1	Striatum
TCGCACCAGGAGGCAG-1	Cortex_2
TCGCATCCCTAAGTGT-1	Fiber_tract
TCGCATTCAATGACTT-1	Cortex_1
TCGCCGAAGTTGCGTC-1	Thalamus_1
TCGCCGGTCGATCCGT-1	Hippocampus
TCGCGTCCAGAAGGTC-1	Hypothalamus_2
TCGCTAAACCGCTATC-1	Cortex_1
TCGCTACTGGCTTTGA-1	Cortex_2
TCGCTCGATATATTCC-1	Hippocampus
TCGCTGGGCGGATTGT-1	Hippocampus
TCGCTGTGCGTAAATC-1	Hippocampus
TCGCTTTAAACGTTTG-1	Cortex_1
TCGGAATGACCATCAA-1	Cortex_5
TCGGAATGCGCTCTGA-1	Thalamus_2
TCGGACGCCCAGCCCA-1	Striatum
TCGGAGAGTATCGGGA-1	Thalamus_2
TCGGAGTACATGAGTA-1	Hippocampus
TCGGCGAACCCAAACC-1	Cortex_5
TCGGGAGACAGCGTAC-1	Cortex_2
TCGGGCCGTCGTGGTA-1	Cortex_3
TCGGGTGAAACTGCTA-1	Cortex_1
TCGGTCCCGACAATAG-1	Thalamus_2
TCGGTCCCTGACTCCA-1	Cortex_4
TCGTAAGACGACATTG-1	Fiber_tract
TCGTATAGTGCAATTA-1	Cortex_3
TCGTATTACCCATTGC-1	Thalamus_2
TCGTCAAGTACGCGCA-1	Hypothalamus_1
TCGTCACACTGTTAGC-1	Lateral_ventricle
TCGTCCGCTGGCGTCT-1	Hippocampus
TCGTCTTAGGCGTTAA-1	Cortex_2
TCGTTAGGAGTCCCTA-1	Fiber_tract
TCGTTCGTTATTATGT-1	Cortex_1
TCGTTGCTATCCGGTC-1	Hypothalamus_2
TCGTTGGCTCGTCAAT-1	Cortex_3
TCTAATACTGCCTCAG-1	Hypothalamus_2
TCTACCGTCCACAAGC-1	Hippocampus
TCTAGCAATCTCCGCC-1	Thalamus_1
TCTAGCATCTTCGATG-1	Pyramidal_layer_dentate_gyrus
TCTAGCATGCCCAGAA-1	Striatum
TCTAGGTGGCGACGCT-1	Cortex_1
TCTAGTGATATCGTGG-1	Cortex_3
TCTAGTTATCAGAAGA-1	Thalamus_1
TCTATCATGCAGTTAC-1	Hippocampus
TCTATCGGTCGCAACA-1	Pyramidal_layer
TCTATTACGCTGGCGA-1	Fiber_tract
TCTCATGAGATAGGGT-1	Cortex_2
TCTCCAACGTAGGTTA-1	Cortex_3
TCTCCCTGGGCAGCGT-1	Cortex_2
TCTCGAACGAGGTCAC-1	Cortex_5
TCTCGGCTCCAGGACT-1	Cortex_1
TCTCTAATAGCTGGTA-1	Hippocampus
TCTCTTACCGCGAACC-1	Hypothalamus_1
TCTGAACCGGTCGGCT-1	Hippocampus
TCTGAACTCGTACCCG-1	Cortex_3
TCTGAAGCACGTGGTC-1	Cortex_5
TCTGAATTCCGTACAA-1	Cortex_3
TCTGATGTATTCTGTC-1	Cortex_2
TCTGCCAGAAACTGCA-1	Striatum
TCTGCGTCCGGTTTCT-1	Hippocampus
TCTGGGAACCTTTGAA-1	Cortex_1
TCTGGGTAGCGCTCAT-1	Thalamus_1
TCTGTCATACAAGAGC-1	Cortex_1
TCTGTGACTGACCGTT-1	Cortex_1
TCTGTGCCATCATAGT-1	Striatum
TCTGTGGCTACATTTC-1	Cortex_5
TCTGTTACCCAGCATA-1	Hypothalamus_2
TCTTACAGAGGTACCG-1	Hippocampus
TCTTACCGGAACTCGT-1	Cortex_1
TCTTACGGCATCCGAC-1	Hippocampus
TCTTACTTATGCCTCT-1	Cortex_3
TCTTAGAGTGAACTCT-1	Cortex_2
TCTTCCCATGGGCACA-1	Cortex_1
TCTTCGAATAGACGTT-1	Lateral_ventricle
TCTTCGATACCAATAA-1	Pyramidal_layer_dentate_gyrus
TCTTCTATAACCCGCC-1	Lateral_ventricle
TCTTGATGCGTAGCGA-1	Hippocampus
TCTTGCTCCCGATACT-1	Cortex_2
TCTTGGTAACACCAAA-1	Hippocampus
TCTTTAAGACTATGAA-1	Cortex_1
TCTTTCTCTTAAGGAG-1	Cortex_5
TGAAACTTATGCAAGC-1	Cortex_1
TGAAAGGACCTGACTC-1	Striatum
TGAACAAGCAGGGACT-1	Hypothalamus_1
TGAATGAGTGTTTCCC-1	Lateral_ventricle
TGACATCGAGCGGACC-1	Cortex_4
TGACCAAATCTTAAAC-1	Cortex_2
TGACCCACGTTAGACA-1	Thalamus_1
TGACGAATATTTCCCT-1	Thalamus_2
TGACGATGCACTAGAA-1	Cortex_3
TGACTATAATCCTTTC-1	Lateral_ventricle
TGACTCCGAATCATAC-1	Hypothalamus_1
TGAGAATGCTTTACCG-1	Pyramidal_layer
TGAGAGATTTACCACG-1	Cortex_3
TGAGATCAAATACTCA-1	Cortex_4
TGAGATTAGGCCCTAA-1	Cortex_4
TGAGCAGTCGTGAAGT-1	Cortex_4
TGAGCCATACAGTCTC-1	Thalamus_1
TGAGCGGAAAGTGTTC-1	Striatum
TGAGCTTTAATGACGC-1	Cortex_1
TGAGGAGTGCCAGCTT-1	Striatum
TGAGTAAATTAGCGTA-1	Fiber_tract
TGAGTGCCTCTTAAAT-1	Thalamus_1
TGAGTGGTCCGTGACG-1	Cortex_3
TGATACATTTAGCCGT-1	Hypothalamus_2
TGATCAGGGAACTGCT-1	Thalamus_2
TGATCGGTTTGACCCT-1	Pyramidal_layer_dentate_gyrus
TGATCTCCGGCGCCAG-1	Hypothalamus_2
TGATTCCCGGTTACCT-1	Striatum
TGATTCGTCTATCACT-1	Thalamus_1
TGATTCTGTCGCCGGT-1	Hypothalamus_2
TGATTTATTAGCTGTG-1	Thalamus_1
TGATTTCCTCCTGACG-1	Hippocampus
TGCAACCCATCTGCGG-1	Cortex_2
TGCAAGAATGACGTAA-1	Pyramidal_layer_dentate_gyrus
TGCACGAGTCGGCAGC-1	Cortex_4
TGCAGAACTATATCGT-1	Thalamus_2
TGCAGAGTACCGAGCA-1	Thalamus_1
TGCAGATCGTCCTAGG-1	Thalamus_2
TGCAGCTACGTACTTC-1	Thalamus_2
TGCAGGATCGGCAAAG-1	Fiber_tract
TGCAGTGGTAGGGAAC-1	Hypothalamus_1
TGCAGTTTCCTCCCAT-1	Cortex_3
TGCATATGTCTGTCAC-1	Cortex_3
TGCATGGATCGGATCT-1	Fiber_tract
TGCATGTGGTAATCTA-1	Cortex_3
TGCCAAAGTCAGACTT-1	Thalamus_2
TGCCAATGGGTACTCT-1	Fiber_tract
TGCCACCTGGCGAAAC-1	Cortex_3
TGCCAGTACGTGGAGA-1	Striatum
TGCCATTACTAAAGAA-1	Cortex_1
TGCCCGTACCGTTAAA-1	Striatum
TGCCGGATGTACGAGC-1	Hypothalamus_1
TGCCGTGGATCGTCCT-1	Striatum
TGCCTGACATCGGTCA-1	Hippocampus
TGCCTGATCAAACGAT-1	Fiber_tract
TGCCTTGGCCAGGCAA-1	Cortex_2
TGCGACACCCTAGTGC-1	Thalamus_1
TGCGACGGCCGAACGT-1	Hypothalamus_1
TGCGAGAATATTACCC-1	Hypothalamus_2
TGCGCAAAGCATTTGG-1	Pyramidal_layer_dentate_gyrus
TGCGCGATTAACGGAG-1	Hippocampus
TGCGGAGTAAAGGTGC-1	Lateral_ventricle
TGCGGCATAGTTCAAC-1	Cortex_1
TGCGGTGAAATTTCAT-1	Cortex_1
TGCGTAAGAACCTGAT-1	Thalamus_1
TGCGTCATGACTGAGC-1	Thalamus_2
TGCGTGATTGGGTGTC-1	Hippocampus
TGCGTTTGTTGACACT-1	Striatum
TGCTAAGTGTCTATTT-1	Cortex_3
TGCTATACAAACGGAC-1	Cortex_4
TGCTATGGCAAAGGGA-1	Hypothalamus_1
TGCTCCACAGTTCTTA-1	Cortex_3
TGCTCGGCGAAACCCA-1	Striatum
TGCTCGGTGGGTCACC-1	Cortex_5
TGCTCTTGAGAGTTTG-1	Cortex_2
TGCTGGTTGGACAATT-1	Hippocampus
TGCTGTTGAAGAACTC-1	Fiber_tract
TGCTTAGAGAGAATGC-1	Hypothalamus_1
TGCTTCCCAAGCAGTA-1	Cortex_2
TGCTTGAAACCATGCA-1	Hippocampus
TGGAAGAAGGGAACGT-1	Thalamus_1
TGGAAGACGAACACCA-1	Fiber_tract
TGGAAGGATAAAGATG-1	Fiber_tract
TGGAATTAGACGCTTT-1	Lateral_ventricle
TGGACCAATCTAAGAT-1	Cortex_2
TGGACCACGGCGTTGA-1	Hippocampus
TGGACGCAATCCAGCC-1	Hypothalamus_1
TGGACTGTTCGCTCAA-1	Lateral_ventricle
TGGAGCTAAAGTTCCC-1	Cortex_4
TGGAGTGATGCGATGA-1	Thalamus_1
TGGCAAACTAAATTAC-1	Cortex_2
TGGCAACTCGCGCGCC-1	Cortex_1
TGGCAAGCACAAGTCG-1	Striatum
TGGCAGATTACGATCA-1	Hypothalamus_2
TGGCAGCAGTAATAGT-1	Hypothalamus_2
TGGCCAAACTGAAGTA-1	Lateral_ventricle
TGGCCGTATATTGACC-1	Hippocampus
TGGCGACTGCTCCAAA-1	Fiber_tract
TGGCGATCAAGTTATG-1	Fiber_tract
TGGCGGTGTGCGATTG-1	Cortex_1
TGGCTATGTGACATAC-1	Cortex_5
TGGCTTTGGGTAGACA-1	Hippocampus
TGGGAAATGCCTTTCC-1	Pyramidal_layer
TGGGCACAAACAGAAC-1	Cortex_1
TGGGCACGTTCTATGG-1	Cortex_1
TGGGCCACAAGAGCGC-1	Cortex_3
TGGGCCCATACTAATT-1	Cortex_3
TGGGCGATACAATAAG-1	Lateral_ventricle
TGGGTAAGGTTCCCGC-1	Cortex_1
TGGGTTTCGGGCGTAC-1	Hypothalamus_1
TGGTAGAATATATGGG-1	Cortex_2
TGGTATCGCATCCCAA-1	Cortex_4
TGGTATCGGTCTGTAT-1	Cortex_4
TGGTCCCACGCTACGG-1	Cortex_2
TGGTCTGTTGGGCGTA-1	Thalamus_2
TGGTTCAACGGGTAAT-1	Cortex_2
TGGTTCGTAGCAAAGG-1	Hippocampus
TGGTTGGAGGATCCTG-1	Cortex_5
TGTACCTACACGAGGG-1	Cortex_2
TGTACGAACAAATCCG-1	Hypothalamus_2
TGTACTGTGCCAAAGT-1	Cortex_4
TGTAGGAGAAATTTCC-1	Cortex_3
TGTAGTGATCTATAAT-1	Thalamus_1
TGTATAACAGATCCTG-1	Fiber_tract
TGTATCCTTATTCCAT-1	Cortex_1
TGTATGGCGCAGACAG-1	Cortex_3
TGTCCCGACATAGCAC-1	Cortex_1
TGTCCGTGGCGCCTTT-1	Thalamus_2
TGTCCTAAGTCACCGC-1	Thalamus_2
TGTCGGCATGGTGGAA-1	Cortex_1
TGTCGTTATCACATAT-1	Hypothalamus_1
TGTCTACAGTTTCTGT-1	Cortex_1
TGTGACTACGCCAGTC-1	Cortex_3
TGTGAGACTAGCCCAA-1	Cortex_2
TGTGCCGGTGCCGGAA-1	Cortex_2
TGTGCTTTACGTAAGA-1	Thalamus_2
TGTGGCAAAGCGTATG-1	Cortex_3
TGTGGCGGGCTTCTGG-1	Striatum
TGTGGTTGCTAAAGCT-1	Lateral_ventricle
TGTGTCGCGAGTTGCA-1	Pyramidal_layer_dentate_gyrus
TGTGTTCGTATCCAAG-1	Thalamus_2
TGTTATTGTATGTGGC-1	Cortex_2
TGTTCCGCTTCCATGA-1	Thalamus_1
TGTTCGTATTGCGGTG-1	Fiber_tract
TGTTCTTCCATTGACT-1	Thalamus_1
TGTTGTCAAGAAGTCT-1	Cortex_3
TGTTTAATACTTCATC-1	Cortex_4
TGTTTCGGTACTTCTC-1	Hippocampus
TTAAACAGAGTCCCGC-1	Cortex_3
TTAAACCGGTAGCGAC-1	Cortex_1
TTAAACTCGAATTCAT-1	Cortex_1
TTAACACCTCGAACAT-1	Pyramidal_layer
TTAACCAACCCTCCCT-1	Pyramidal_layer
TTAACGTCGCAAGACC-1	Cortex_1
TTAACTTCAGGTAGGA-1	Thalamus_2
TTAAGATAGGATTGAC-1	Cortex_4
TTAAGCCGACAACTTC-1	Cortex_1
TTAAGCGCCTGACCCA-1	Thalamus_1
TTAAGGATACGGAGGT-1	Cortex_1
TTAAGGCCCGTACTTT-1	Hypothalamus_1
TTAATCAGTACGTCAG-1	Cortex_3
TTAATGTAGACCAGGT-1	Pyramidal_layer_dentate_gyrus
TTAATTGCTTTGGGTG-1	Cortex_2
TTAATTTCAGACGCGG-1	Cortex_3
TTACAACTACGCATCC-1	Hippocampus
TTACAGACCTAAATGA-1	Cortex_1
TTACATCGTGGCCTGG-1	Hippocampus
TTACATGCCACAACTA-1	Cortex_5
TTACCATTGATTACCC-1	Thalamus_2
TTACCCATTGCCGGGT-1	Cortex_1
TTACCCTAACAGTCCT-1	Pyramidal_layer
TTACCCTAGGGATTGG-1	Striatum
TTACCGCCTTAGGGAA-1	Hippocampus
TTACGGATGGTTCGAG-1	Cortex_3
TTACGGTGTCACCGAG-1	Cortex_4
TTACTAAAGGACTTTA-1	Cortex_2
TTACTATCGGCTTCTC-1	Thalamus_2
TTACTCCGGCCGGGAA-1	Fiber_tract
TTACTCTGGTACGTAC-1	Thalamus_2
TTACTGGGATATTTCA-1	Hypothalamus_2
TTAGAAGAACATGACT-1	Striatum
TTAGAATAAGGGTCGG-1	Hypothalamus_2
TTAGACACGATCGTTG-1	Cortex_1
TTAGACGAGTCACCTC-1	Cortex_2
TTAGAGTTTAGAAGGA-1	Cortex_2
TTAGATAGGTCGATAC-1	Hippocampus
TTAGCAACATGGATGT-1	Hippocampus
TTAGCTAATACGATCT-1	Cortex_4
TTAGCTGATTTGCCGT-1	Cortex_3
TTAGGTCATAACCGAC-1	Hypothalamus_1
TTAGTAGGGCGGCGGG-1	Thalamus_2
TTAGTTATTCGTGGCA-1	Cortex_3
TTATAGATGCACATTA-1	Cortex_4
TTATAGGTAATTGTCT-1	Cortex_2
TTATATACGCTGTCAC-1	Lateral_ventricle
TTATATTTGGCAATCC-1	Hippocampus
TTATCCAATCGAACTC-1	Cortex_3
TTATCCGGGATCTATA-1	Cortex_3
TTATCCTCAAGGAATA-1	Thalamus_2
TTATCGCCTGCGAAGC-1	Lateral_ventricle
TTATCTGTATCATAAC-1	Hippocampus
TTATGAATGAAAGGGA-1	Hypothalamus_2
TTATGACAAACTGGAT-1	Hippocampus
TTATGATCTTAACGAA-1	Striatum
TTATGCGTCCCGGTCC-1	Cortex_1
TTATGTTTGCGATAGA-1	Hippocampus
TTATTAGAGCGTGTTC-1	Lateral_ventricle
TTATTAGGGAAGCATC-1	Cortex_3
TTCAAAGTCTCTAGCC-1	Lateral_ventricle
TTCAACGACCCGACCG-1	Hippocampus
TTCAAGCCGAGCTGAG-1	Cortex_1
TTCAATACTCTGAATC-1	Cortex_3
TTCAATTAGCCATAAT-1	Cortex_4
TTCACGAAAGGATCAC-1	Thalamus_1
TTCACGGTCGTCACGT-1	Hypothalamus_1
TTCACTCGAGCACCTA-1	Cortex_2
TTCAGAGTAACCTGAC-1	Cortex_1
TTCAGCCCTGGTCCAC-1	Cortex_2
TTCAGCTGGCGTGCCC-1	Cortex_2
TTCAGGCGTCAAAGCC-1	Thalamus_2
TTCATGGCGCAACAGG-1	Cortex_3
TTCCAATCAGAGCTAG-1	Cortex_1
TTCCAATCTGGCTATC-1	Hypothalamus_2
TTCCACACAGATTTGA-1	Hypothalamus_2
TTCCGCAGAGAAATAT-1	Cortex_5
TTCCGCGTGAGGCGAT-1	Fiber_tract
TTCCGGCCTTGAGGCT-1	Hypothalamus_2
TTCCGGTTACCCACTT-1	Cortex_2
TTCCTCGAGGGTGTCT-1	Hippocampus
TTCCTCGGACTAACCA-1	Cortex_2
TTCCTTTCTGTGTTGC-1	Cortex_3
TTCGACAGAGCCCGTG-1	Striatum
TTCGACGGGAAGGGCG-1	Pyramidal_layer_dentate_gyrus
TTCGCACTCGCGTGCT-1	Pyramidal_layer_dentate_gyrus
TTCGCACTGTACGACA-1	Striatum
TTCGCATCCGGAAGCA-1	Cortex_1
TTCGCGCGCCATACGA-1	Fiber_tract
TTCGCTATCTGACGTG-1	Cortex_5
TTCGGCAACCCGCTGA-1	Cortex_1
TTCGGCTAGAGATGGT-1	Fiber_tract
TTCGGGACTAATCGCG-1	Fiber_tract
TTCGGGCGCTAGTCTT-1	Hypothalamus_1
TTCGGTACTGTAGAGG-1	Cortex_5
TTCGTAATCCCAGCGG-1	Cortex_4
TTCGTACTCCAGAACG-1	Thalamus_2
TTCTAACCGAAGCTTA-1	Cortex_3
TTCTACCTCAATCGGT-1	Hypothalamus_1
TTCTACTTGCGAGGGC-1	Hippocampus
TTCTAGAAAGTCTTAT-1	Lateral_ventricle
TTCTAGGCCAATTGTG-1	Hippocampus
TTCTATTAAACGCAGC-1	Lateral_ventricle
TTCTCAATTGCTACAA-1	Hypothalamus_1
TTCTGACCGGGCTCAA-1	Cortex_2
TTCTGCCGCGCCTAGA-1	Striatum
TTCTGCGAGCGCCCTT-1	Thalamus_2
TTCTGCGGGTTAGCGG-1	Striatum
TTCTTAGTGAACGGTG-1	Pyramidal_layer
TTCTTAGTGGCTCAGA-1	Fiber_tract
TTCTTATCCGCTGGGT-1	Cortex_2
TTCTTGAGCCGCGCTA-1	Thalamus_1
TTCTTGGACGATCTGC-1	Thalamus_1
TTCTTGGAGTAATGAG-1	Cortex_3
TTCTTGTAACCTAATG-1	Hippocampus
TTGAACGAATCCTTTG-1	Fiber_tract
TTGAACGACGTGCTGA-1	Cortex_2
TTGAAGAATTCCCAGG-1	Thalamus_1
TTGAATATGGACTTTC-1	Lateral_ventricle
TTGAATTCACGTGAGG-1	Cortex_1
TTGACAGGAGCTCCCG-1	Cortex_2
TTGACATGAACGTGGA-1	Thalamus_1
TTGACCAGGAACAACT-1	Cortex_2
TTGACCATGTTCTCCG-1	Cortex_3
TTGACCGTGTTAATGA-1	Fiber_tract
TTGACGATTCAGCACG-1	Cortex_1
TTGACGCTCCATGAGC-1	Cortex_4
TTGACTACCATATGGT-1	Thalamus_1
TTGACTATTGTCCGGC-1	Cortex_5
TTGAGAAGTTTAGCAT-1	Cortex_5
TTGAGAGTACTGCTAA-1	Thalamus_1
TTGATCTAACTTTGTC-1	Thalamus_1
TTGATGCCGCTCGTCG-1	Hypothalamus_1
TTGATGTGTAGTCCCG-1	Cortex_1
TTGATTAGCTGTTTCT-1	Thalamus_1
TTGATTATGCAGATGA-1	Hippocampus
TTGCACAATTCAGAAA-1	Hypothalamus_2
TTGCACGGAGCAGCAC-1	Hippocampus
TTGCATGCTGATCACG-1	Thalamus_1
TTGCCATAGCCCGCTC-1	Thalamus_2
TTGCCCTGATCACGGG-1	Thalamus_1
TTGCCGCAGACCTACA-1	Hypothalamus_1
TTGCCGCTTTCTAGTA-1	Cortex_2
TTGCCTAATCCAAAGT-1	Hypothalamus_1
TTGCGGCATCAGAAAG-1	Hypothalamus_2
TTGCGTAGTTTGAGGA-1	Hippocampus
TTGCGTCGGCCAACCG-1	Hypothalamus_2
TTGCTCCCATACCGGA-1	Fiber_tract
TTGCTGAAGGAACCAC-1	Pyramidal_layer
TTGCTGATCATGTTCG-1	Thalamus_1
TTGCTGCACCTATCCA-1	Fiber_tract
TTGCTGGCCGGGCTTC-1	Cortex_5
TTGGAAGAATACAGTC-1	Thalamus_1
TTGGACATGTGGCTTA-1	Thalamus_2
TTGGACCATCTGGCAA-1	Cortex_5
TTGGACCTATAACAGT-1	Cortex_5
TTGGAGTCTCCCTTCT-1	Cortex_1
TTGGATATCGTCTACG-1	Fiber_tract
TTGGATCGACTTCTGG-1	Cortex_1
TTGGATTGGGTACCAC-1	Hippocampus
TTGGCCATCTTGCGCT-1	Fiber_tract
TTGGCCTAGAATTTCG-1	Cortex_1
TTGGCTCGCATGAGAC-1	Hippocampus
TTGGGAAGACGAGCCG-1	Lateral_ventricle
TTGGGACACTGCCCGC-1	Pyramidal_layer_dentate_gyrus
TTGGGCGGCGGTTGCC-1	Lateral_ventricle
TTGGTCACACTCGTAA-1	Hypothalamus_2
TTGGTTGCGGTGCGCG-1	Thalamus_2
TTGTAAGGACCTAAGT-1	Thalamus_1
TTGTAAGGCCAGTTGG-1	Cortex_3
TTGTAATCCGTACTCG-1	Thalamus_1
TTGTATCACACAGAAT-1	Cortex_1
TTGTCGTTCAGTTACC-1	Hippocampus
TTGTGAACCTAATCCG-1	Cortex_5
TTGTGCAGCCACGTCA-1	Cortex_2
TTGTGGCCCTGACAGT-1	Hippocampus
TTGTGGTAGGAGGGAT-1	Thalamus_1
TTGTGTATGCCACCAA-1	Striatum
TTGTGTTTCCCGAAAG-1	Fiber_tract
TTGTTCAGTGTGCTAC-1	Hippocampus
TTGTTGTGTGTCAAGA-1	Lateral_ventricle
TTGTTTCACATCCAGG-1	Hypothalamus_1
TTGTTTCATTAGTCTA-1	Hypothalamus_1
TTGTTTCCATACAACT-1	Thalamus_2
TTGTTTGTGTAAATTC-1	Cortex_4
